0 עוד עוד עוד adverb unspecified unspecified unspecified unspecified unspecified  	O	null

0 קיץ קיץ קיץ noun masculine singular absolute unspecified unspecified  	I_DATE	null

0 ו ו ושוב conjunction unspecified unspecified unspecified unspecified unspecified 0 
0 שוב שוב ושוב adverb unspecified unspecified unspecified unspecified unspecified  	O	null

0 סתיו סתיו סתיו noun masculine singular absolute unspecified unspecified  	I_DATE	null

0 ו ו ושוב conjunction unspecified unspecified unspecified unspecified unspecified 0 
0 שוב שוב ושוב adverb unspecified unspecified unspecified unspecified unspecified  	O	null

0 עוד עוד עוד adverb unspecified unspecified unspecified unspecified unspecified  	O	null

0 חורף חורף חורף noun masculine singular absolute unspecified unspecified  	I_DATE	null

0 ל ל למלחמה preposition unspecified unspecified unspecified unspecified unspecified 0 
0 מלחמה מלחמה למלחמה noun feminine singular absolute unspecified unspecified  	O	null

0 נפנה נפנה נפנה verb masculine singular unspecified 3 past  	O	null

0 ה ה העורף definiteArticle unspecified unspecified unspecified unspecified unspecified 0 
0 העורף עורף העורף noun masculine singular absolute unspecified unspecified  	O	null

0 אם אם אם conjunction unspecified unspecified unspecified unspecified unspecified  	O	null

0 הגענו הגיע הגענו verb masculine-and-feminine plural unspecified 1 past  	O	null

0 עד עד עד noun masculine singular absolute unspecified unspecified  	O	null

0 ה ה הלום definiteArticle unspecified unspecified unspecified unspecified unspecified 0 
0 הלום לום הלום noun masculine singular absolute unspecified unspecified  	O	null

0 נושיט הושיט נושיט verb masculine-and-feminine plural unspecified 1 future  	O	null

0 יד יד יד noun feminine singular construct unspecified unspecified  	O	null

0 רועדת רעד רועדת verb feminine singular unspecified any beinoni  	O	null

0 ל ל לשלום preposition unspecified unspecified unspecified unspecified unspecified 0 
0 שלום שלום לשלום noun masculine singular absolute unspecified unspecified  	O	null

