0 ה ה השחפים definiteArticle unspecified unspecified unspecified unspecified unspecified 0 
0 השחפים שחף השחפים noun masculine plural absolute unspecified unspecified  	O	null

0 על על על preposition unspecified unspecified unspecified unspecified unspecified  	O	null

0 ה ה המזח definiteArticle unspecified unspecified unspecified unspecified unspecified 0 
0 המזח מזח המזח noun masculine singular absolute unspecified unspecified  	O	null

0 כבר כבר כבר adverb unspecified unspecified unspecified unspecified unspecified  	O	null

0 עפו עף עפו verb masculine-and-feminine plural unspecified 3 past  	O	null

0 ו ו והים conjunction unspecified unspecified unspecified unspecified unspecified 0 
0 ה ה והים definiteArticle unspecified unspecified unspecified unspecified unspecified 0 
0 הים ים והים noun masculine singular absolute unspecified unspecified  	O	null

0 השתתק השתתק השתתק verb masculine singular unspecified 3 past  	O	null

0 ו ו ונדם conjunction unspecified unspecified unspecified unspecified unspecified 0 
0 נד נד ונדם participle masculine singular unspecified any unspecified  
0 ם ם ונדם possessive masculine plural unspecified 3 unspecified 0 	O	null

0 זוהי זהו זוהי pronoun feminine singular unspecified 3 unspecified  	O	null

0 יפו יפו יפו properName unspecified unspecified unspecified unspecified unspecified  	I_LOC	null

0 ילדה ילד ילדה noun feminine singular absolute unspecified unspecified  	O	null

0 זוהי זהו זוהי pronoun feminine singular unspecified 3 unspecified  	O	null

0 יפו יפו יפו properName unspecified unspecified unspecified unspecified unspecified  	I_LOC	null

0 ש ש שחודרת relativizer/subordinatingConjunction unspecified unspecified unspecified unspecified unspecified 0 
0 חודרת חדר שחודרת verb feminine singular unspecified any beinoni  	O	null

0 - - - punctuation unspecified unspecified unspecified unspecified unspecified  	O	null

0 כמו כמו כמו preposition unspecified unspecified unspecified unspecified unspecified  	O	null

0 יין יין יין noun masculine singular absolute unspecified unspecified  	O	null

0 - - - punctuation unspecified unspecified unspecified unspecified unspecified  	O	null

0 ל ל לדם preposition unspecified unspecified unspecified unspecified unspecified 0 
0 דם דם לדם noun masculine singular absolute unspecified unspecified  	O	null

