0 בין בין בין preposition unspecified unspecified unspecified unspecified unspecified  	O	null

0 איילת אייל איילת properName unspecified unspecified unspecified unspecified unspecified  	I_PERS	null

0 ו ו ומטולה conjunction unspecified unspecified unspecified unspecified unspecified 0 
0 מטולה מטולה ומטולה properName unspecified unspecified unspecified unspecified unspecified  	I_LOC	null

0 שם שם שם adverb unspecified unspecified unspecified unspecified unspecified  	O	null

0 עייפתי עייף עייפתי verb masculine-and-feminine singular unspecified 1 past  	O	null

0 ו ו ואשב conjunction unspecified unspecified unspecified unspecified unspecified 0 
0 אשב ישב ואשב verb masculine-and-feminine singular unspecified 1 future  	O	null

0 פרח פרח פרח noun masculine singular absolute unspecified unspecified  	O	null

0 חן חן חן noun masculine singular absolute unspecified unspecified  	O	null

0 לקטוף קטף לקטוף verb unspecified unspecified unspecified unspecified infinitive  	O	null

0 חפצתי חפץ חפצתי verb masculine-and-feminine singular unspecified 1 past  	O	null

0 ו ו וננעץ conjunction unspecified unspecified unspecified unspecified unspecified 0 
0 ננעץ ננעץ וננעץ verb masculine singular unspecified 3 past  	O	null

0 ל ל לי preposition unspecified unspecified unspecified unspecified unspecified  
0 י י לי pronomial masculine-and-feminine singular unspecified 1 unspecified 0 	O	null

0 קוץ קוץ קוץ noun masculine singular absolute unspecified unspecified  	O	null

0 ב ב בלב preposition unspecified unspecified unspecified unspecified unspecified 0 
0 לב לב בלב noun masculine singular absolute unspecified unspecified  	O	null

0 את את את at-preposition unspecified unspecified unspecified unspecified unspecified  	O	null

0 ה ה היקום definiteArticle unspecified unspecified unspecified unspecified unspecified 0 
0 היקום יקום היקום noun masculine singular absolute unspecified unspecified  	O	null

0 פתאום פתאום פתאום adverb unspecified unspecified unspecified unspecified unspecified  	O	null

0 לפתע לפתע לפתע adverb unspecified unspecified unspecified unspecified unspecified  	O	null

0 ערפילים ערפל ערפילים noun masculine plural absolute unspecified unspecified  	O	null

0 הליטו הליט הליטו verb masculine-and-feminine plural unspecified 2 imperative  	O	null

0 לוט לוט לוט noun masculine singular absolute unspecified unspecified  	O	null

0 תכול תכול תכול adjective masculine singular absolute unspecified unspecified  	O	null

0 מרחב מרחב מרחב noun masculine singular construct unspecified unspecified  	O	null

0 גזלו גזל גזלו verb masculine-and-feminine plural unspecified 3 past  	O	null

0 מן מן ממני preposition unspecified unspecified unspecified unspecified unspecified  
0 י י ממני pronomial masculine-and-feminine singular unspecified 1 unspecified 0 	O	null

0 שתי CARD2 שתי numeral feminine dual construct unspecified unspecified  	O	null

0 עיניים עין עיניים noun feminine plural absolute unspecified unspecified  	O	null

0 כחולות כחול כחולות adjective feminine plural absolute unspecified unspecified  	O	null

0 בין בין בין preposition unspecified unspecified unspecified unspecified unspecified  	O	null

0 איילת אייל איילת properName unspecified unspecified unspecified unspecified unspecified  	I_PERS	null

0 ו ו ומטולה conjunction unspecified unspecified unspecified unspecified unspecified 0 
0 מטולה מטולה ומטולה properName unspecified unspecified unspecified unspecified unspecified  	I_LOC	null

0 תרמילי תרמיל תרמילי noun masculine plural construct unspecified unspecified  	O	null

0 נפל נפל נפל verb masculine singular unspecified 3 past  	O	null

0 ב ב בגיא preposition unspecified unspecified unspecified unspecified unspecified 0 
0 גיא גיא בגיא properName masculine singular unspecified unspecified unspecified  	I_PERS	null

0 יד יד יד noun feminine singular construct unspecified unspecified  	O	null

0 רכה רך רכה adjective feminine singular absolute unspecified unspecified  	O	null

0 שם שם שם adverb unspecified unspecified unspecified unspecified unspecified  	O	null

0 בליל בליל בליל noun masculine singular construct unspecified unspecified  	O	null

0 חושך חושך חושך noun masculine singular absolute unspecified unspecified  	O	null

0 גזזה גזז גזזה verb feminine singular unspecified 3 past  	O	null

0 מחלפות מחלפה מחלפותי noun feminine plural absolute unspecified unspecified  
0 י י מחלפותי possessive masculine-and-feminine singular unspecified 1 unspecified 0 	O	null

