0 אז אז אז conjunction unspecified unspecified unspecified unspecified unspecified  	O	null

0 בוא בוא בואי noun masculine singular absolute unspecified unspecified  
0 י י בואי possessive masculine-and-feminine singular unspecified 1 unspecified 0 	O	null

0 ו ו ונלך conjunction unspecified unspecified unspecified unspecified unspecified 0 
0 נלך הלך ונלך verb masculine-and-feminine plural unspecified 1 future  	O	null

0 עכשיו עכשיו עכשיו adverb unspecified unspecified unspecified unspecified unspecified  	O	null

0 כמו כמו כמו preposition unspecified unspecified unspecified unspecified unspecified  	O	null

0 פעם פעם פעם noun feminine singular absolute unspecified unspecified  	O	null

0 נתפלל התפלל נתפלל verb masculine-and-feminine plural unspecified 1 future  	O	null

0 בתוך בתוך בתוך preposition unspecified unspecified unspecified unspecified unspecified  	O	null

0 ה ה הפרדסים definiteArticle unspecified unspecified unspecified unspecified unspecified 0 
0 הפרדסים פרדס הפרדסים noun masculine plural absolute unspecified unspecified  	O	null

0 ש ש שיוסיפו relativizer/subordinatingConjunction unspecified unspecified unspecified unspecified unspecified 0 
0 יוסיפו הוסיף שיוסיפו verb masculine-and-feminine plural unspecified 3 future  	O	null

0 ל ל לחיים preposition unspecified unspecified unspecified unspecified unspecified 0 
0 חיים חיים לחיים properName masculine singular unspecified unspecified unspecified  	I_PERS	null

0 קצת קצת קצת adverb unspecified unspecified unspecified unspecified unspecified  	O	null

0 טעם טעם טעם noun masculine singular absolute unspecified unspecified  	O	null

0 ו ו וישלחו conjunction unspecified unspecified unspecified unspecified unspecified 0 
0 ישלחו שלח וישלחו verb masculine-and-feminine plural unspecified 3 future  	O	null

0 לנו לן לנו verb masculine-and-feminine plural unspecified 1 past  	O	null

0 כמה כמה כמה quantifier unspecified unspecified construct unspecified unspecified  	O	null

0 ניסים ניסים ניסים properName masculine singular unspecified unspecified unspecified  	I_PERS	null

