0 ליבי ליבי ליבי properName unspecified unspecified unspecified unspecified unspecified  	I_PERS	null

0 יוצא יוצא יוצא noun masculine singular absolute unspecified unspecified  	O	null

0 אליה אליה אליה properName unspecified unspecified unspecified unspecified unspecified  	I_PERS	null

0 ו ו ומבקש conjunction unspecified unspecified unspecified unspecified unspecified 0 
0 מבקש ביקש ומבקש verb masculine singular unspecified any beinoni  	O	null

0 את את אותה at-preposition unspecified unspecified unspecified unspecified unspecified  
0 ה ה אותה pronomial feminine singular unspecified 3 unspecified 0 	O	null

0 מלך מלך מלכה noun masculine singular absolute unspecified unspecified  
0 ה ה מלכה possessive feminine singular unspecified 3 unspecified 0 	O	null

0 כמו כמו כמוה preposition unspecified unspecified unspecified unspecified unspecified  
0 ה ה כמוה pronomial feminine singular unspecified 3 unspecified 0 	O	null

0 אין יש אין existential unspecified unspecified unspecified unspecified unspecified  	O	null

0 לא לא לא negation unspecified unspecified unspecified unspecified unspecified  	O	null

0 תהיה תהייה תהיה noun feminine singular absolute unspecified unspecified  	O	null

0 ו ו ולא conjunction unspecified unspecified unspecified unspecified unspecified 0 
0 לא לא ולא negation unspecified unspecified unspecified unspecified unspecified  	O	null

0 היתה הוא היתה copula feminine singular unspecified 3 past  	O	null

0 הילה הילה הילה properName masculine singular unspecified unspecified unspecified  	I_PERS	null

0 ש ש שמסנוורת relativizer/subordinatingConjunction unspecified unspecified unspecified unspecified unspecified 0 
0 מסנוורת סנוור שמסנוורת verb feminine singular unspecified any beinoni  	O	null

0 עוטפת עטף עוטפת verb feminine singular unspecified any beinoni  	O	null

0 את את את at-preposition unspecified unspecified unspecified unspecified unspecified  	O	null

0 גוף גוף גופה noun masculine singular absolute unspecified unspecified  
0 ה ה גופה possessive feminine singular unspecified 3 unspecified 0 	O	null

0 כמו כמו כמו preposition unspecified unspecified unspecified unspecified unspecified  	O	null

0 פרח פרח פרח noun masculine singular absolute unspecified unspecified  	O	null

0 מעוטרת עוטר מעוטרת verb feminine singular unspecified any beinoni  	O	null

0 ו ו והיא conjunction unspecified unspecified unspecified unspecified unspecified 0 
0 היא הוא והיא pronoun feminine singular unspecified 3 unspecified  	O	null

0 כל כול כל quantifier unspecified unspecified construct unspecified unspecified  	O	null

0 כך כך כך adverb unspecified unspecified unspecified unspecified unspecified  	O	null

0 יפה יפה יפה adverb unspecified unspecified unspecified unspecified unspecified  	O	null

0 היא הוא היא pronoun feminine singular unspecified 3 unspecified  	O	null

0 כוכבי כוכב כוכבי properName unspecified unspecified unspecified unspecified unspecified  	I_PERS	null

0 ב ב בלילה preposition unspecified unspecified unspecified unspecified unspecified 0 
0 לילה לילה בלילה noun masculine singular absolute unspecified unspecified  	O	null

0 היא הוא היא pronoun feminine singular unspecified 3 unspecified  	O	null

0 מ מ מאורי preposition unspecified unspecified unspecified unspecified unspecified 0 
0 אורי אורי מאורי properName unspecified unspecified unspecified unspecified unspecified  	I_PERS	null

0 ב ב ביום preposition unspecified unspecified unspecified unspecified unspecified 0 
0 יום יום ביום noun masculine singular absolute unspecified unspecified  	O	null

0 ב ב במחשבתי preposition unspecified unspecified unspecified unspecified unspecified 0 
0 מחשבת מחשבה במחשבתי noun feminine singular absolute unspecified unspecified  
0 י י במחשבתי possessive masculine-and-feminine singular unspecified 1 unspecified 0 	O	null

0 אין יש אין existential unspecified unspecified unspecified unspecified unspecified  	O	null

0 פני פני פני noun masculine singular absolute unspecified unspecified  	O	null

0 ל ל לה preposition unspecified unspecified unspecified unspecified unspecified  
0 ה ה לה pronomial feminine singular unspecified 3 unspecified 0 	O	null

0 מציאות מציאות מציאות noun feminine singular absolute unspecified unspecified  	O	null

0 ו ו וגם conjunction unspecified unspecified unspecified unspecified unspecified 0 
0 גם גם וגם conjunction unspecified unspecified unspecified unspecified unspecified  	O	null

0 חלום חלום חלום noun masculine singular absolute unspecified unspecified  	O	null

0 עוצמת עוצמה עוצמת noun feminine singular construct unspecified unspecified  	O	null

0 את את את at-preposition unspecified unspecified unspecified unspecified unspecified  	O	null

0 עין עין עיניה noun feminine plural absolute unspecified unspecified  
0 ה ה עיניה possessive feminine singular unspecified 3 unspecified 0 	O	null

0 לוקחת לקח לוקחת verb feminine singular unspecified any beinoni  	O	null

0 שאיפה שאיפה שאיפה noun feminine singular absolute unspecified unspecified  	O	null

0 ו ו וכשנכנס conjunction unspecified unspecified unspecified unspecified unspecified 0 
0 כש כש וכשנכנס temporalSubConj unspecified unspecified unspecified unspecified unspecified 0 
0 נכנס נכנס וכשנכנס verb masculine singular unspecified 3 past  	O	null

0 ה ה הקצב definiteArticle unspecified unspecified unspecified unspecified unspecified 0 
0 הקצב קצב הקצב noun masculine singular absolute unspecified unspecified  	O	null

0 ידיים יד ידיים noun feminine plural absolute unspecified unspecified  	O	null

0 מניפה מניפה מניפה noun feminine singular absolute unspecified unspecified  	O	null

