0 רכבת רכבת רכבת noun feminine singular construct unspecified unspecified  	O	null

0 אחרונה אחרון אחרונה adjective feminine singular absolute unspecified unspecified  	O	null

0 יוצאת יצא יוצאת verb feminine singular unspecified any beinoni  	O	null

0 טראנס טראנס טראנס properName unspecified unspecified unspecified unspecified unspecified  	I_LOC	null
1 - - - punctuation unspecified unspecified unspecified unspecified unspecified  	O	null
2 אטלנטית אטלנטית אטלנטית adjective feminine singular absolute unspecified unspecified  	O	null

0 ארוכה ארוך ארוכה adjective feminine singular absolute unspecified unspecified  	O	null

0 ברלין ברלין ברלין properName unspecified unspecified unspecified unspecified unspecified  	I_LOC	null

0 שקטה שקט שקטה adjective feminine singular absolute unspecified unspecified  	O	null

0 נהר נהר נהר noun masculine singular construct unspecified unspecified  	O	null

0 נוצץ נוצץ נוצץ adjective masculine singular absolute unspecified unspecified  	O	null

0 פריז פריז פריז properName unspecified unspecified unspecified unspecified unspecified  	I_LOC	null

0 עדיין עדיין עדיין adverb unspecified unspecified unspecified unspecified unspecified  	O	null

0 רחוקה רחוק רחוקה adjective feminine singular absolute unspecified unspecified  	O	null

0 ב ב בחלון preposition unspecified unspecified unspecified unspecified unspecified 0 
0 ה ה בחלון definiteArticle unspecified unspecified unspecified unspecified unspecified 0 
0 החלון חילון בחלון noun masculine singular absolute unspecified unspecified  	O	null

0 ה ה האור definiteArticle unspecified unspecified unspecified unspecified unspecified 0 
0 האור אור האור noun masculine singular absolute unspecified unspecified  	O	null

0 עורפל עורפל עורפל verb masculine singular unspecified 3 past  	O	null

0 מקור מקור מקור noun masculine singular absolute unspecified unspecified  	O	null

0 ו ו ובתמונה conjunction unspecified unspecified unspecified unspecified unspecified 0 
0 ב ב ובתמונה preposition unspecified unspecified unspecified unspecified unspecified 0 
0 תמונה תמונה ובתמונה noun feminine singular absolute unspecified unspecified  	O	null

0 קטנה קטן קטנה adjective feminine singular absolute unspecified unspecified  	O	null

0 את את את at-preposition unspecified unspecified unspecified unspecified unspecified  	O	null

0 ב ב בשיער preposition unspecified unspecified unspecified unspecified unspecified 0 
0 שיער שיער בשיער noun masculine singular absolute unspecified unspecified  	O	null

0 שחור שחור שחור adjective masculine singular absolute unspecified unspecified  	O	null

0 רעש רעש רעש noun masculine singular absolute unspecified unspecified  	O	null

0 של של של shel-preposition unspecified unspecified unspecified unspecified unspecified  	O	null

0 קטר קטר קטר noun masculine singular absolute unspecified unspecified  	O	null

0 קו קו קו noun masculine singular construct unspecified unspecified  	O	null

0 ה ה המעבר definiteArticle unspecified unspecified unspecified unspecified unspecified 0 
0 המעבר מעבר המעבר noun masculine singular absolute unspecified unspecified  	O	null

0 השארתי השאיר השארתי verb masculine-and-feminine singular unspecified 1 past  	O	null

0 את את את at-preposition unspecified unspecified unspecified unspecified unspecified  	O	null

0 גרמניה גרמניה גרמניה properName unspecified unspecified unspecified unspecified unspecified  	I_LOC	null

0 מאחור מאחור מאחור adverb unspecified unspecified unspecified unspecified unspecified  	O	null

