0 כוס כוס כוס noun feminine singular construct unspecified unspecified  	O	null

0 ה ה היין definiteArticle unspecified unspecified unspecified unspecified unspecified 0 
0 היין יין היין noun masculine singular absolute unspecified unspecified  	O	null

0 ב ב בידי preposition unspecified unspecified unspecified unspecified unspecified 0 
0 ידי יד בידי noun feminine plural construct unspecified unspecified  	O	null

0 טעם טעם טעמו noun masculine singular absolute unspecified unspecified  
0 ו ו טעמו possessive masculine singular unspecified 3 unspecified 0 	O	null

0 כה כה כה adverb unspecified unspecified unspecified unspecified unspecified  	O	null

0 מריר מריר מריר adjective masculine singular absolute unspecified unspecified  	O	null

0 מתוך מתוך מתוכו preposition unspecified unspecified unspecified unspecified unspecified  
0 ו ו מתוכו pronomial masculine singular unspecified 3 unspecified 0 	O	null

0 נשקף נשקף נשקף verb masculine singular unspecified 3 past  	O	null

0 ל ל לי preposition unspecified unspecified unspecified unspecified unspecified  
0 י י לי pronomial masculine-and-feminine singular unspecified 1 unspecified 0 	O	null

0 ה ה החיים definiteArticle unspecified unspecified unspecified unspecified unspecified 0 
0 החיים חיים החיים noun masculine plural absolute unspecified unspecified  	O	null

0 ה ה המרים definiteArticle unspecified unspecified unspecified unspecified unspecified 0 
0 המרים מר המרים adjective masculine plural absolute unspecified unspecified  	O	null

0 איה איה איה properName unspecified unspecified unspecified unspecified unspecified  	I_PERS	null

0 אותו אותו אותו quantifier unspecified unspecified construct unspecified unspecified  	O	null

0 ה ה האדם definiteArticle unspecified unspecified unspecified unspecified unspecified 0 
0 האדם אדם האדם noun masculine singular absolute unspecified unspecified  	O	null

0 אשר אשר אשר properName masculine singular unspecified unspecified unspecified  	I_PERS	null

0 מבין הבין מבין verb masculine singular unspecified any beinoni  	O	null

0 את את את at-preposition unspecified unspecified unspecified unspecified unspecified  	O	null

0 ה ה הזולת definiteArticle unspecified unspecified unspecified unspecified unspecified 0 
0 הזולת זולת הזולת noun masculine singular absolute unspecified unspecified  	O	null

0 את את את at-preposition unspecified unspecified unspecified unspecified unspecified  	O	null

0 אותו אותו אותו quantifier unspecified unspecified construct unspecified unspecified  	O	null

0 ה ה העני definiteArticle unspecified unspecified unspecified unspecified unspecified 0 
0 העני עני העני noun masculine singular absolute unspecified unspecified  	O	null

0 אשר אשר אשר properName masculine singular unspecified unspecified unspecified  	I_PERS	null

0 מביט הביט מביט verb masculine singular unspecified any beinoni  	O	null

0 ב ב בתחנונים preposition unspecified unspecified unspecified unspecified unspecified 0 
0 תחנונים תחנון בתחנונים noun masculine plural absolute unspecified unspecified  	O	null

0 זעקה זעקה זעקה noun feminine singular absolute unspecified unspecified  	O	null

0 מ מ מהחלון preposition unspecified unspecified unspecified unspecified unspecified 0 
0 ה ה מהחלון definiteArticle unspecified unspecified unspecified unspecified unspecified 0 
0 החלון חילון מהחלון noun masculine singular absolute unspecified unspecified  	O	null

0 אלוהים אלוהים אלוהים noun masculine singular absolute unspecified unspecified  	O	null

0 נשאת נישא נשאת verb feminine singular unspecified any beinoni  	O	null

0 לו לו לו conjunction unspecified unspecified unspecified unspecified unspecified  	O	null

0 היא הוא היא pronoun feminine singular unspecified 3 unspecified  	O	null

0 ממול ממול ממול adverb unspecified unspecified unspecified unspecified unspecified  	O	null

0 ב ב בשכונה preposition unspecified unspecified unspecified unspecified unspecified 0 
0 שכונה שכונה בשכונה noun feminine singular absolute unspecified unspecified  	O	null

0 שמחת שמחה שמחת noun feminine singular construct unspecified unspecified  	O	null

0 חתונה חתונה חתונה noun feminine singular absolute unspecified unspecified  	O	null

0 ליבי ליבי ליבי properName unspecified unspecified unspecified unspecified unspecified  	I_PERS	null

0 נכמר נכמר נכמר verb masculine singular unspecified 3 past  	O	null

0 ל ל לאדם preposition unspecified unspecified unspecified unspecified unspecified 0 
0 אדם אדם לאדם noun masculine singular absolute unspecified unspecified  	O	null

0 אשר אשר אשר properName masculine singular unspecified unspecified unspecified  	I_PERS	null

0 יושב יושב יושב noun masculine singular construct unspecified unspecified  	O	null

0 שם שם שם adverb unspecified unspecified unspecified unspecified unspecified  	O	null

0 בדד בדד בדד adverb unspecified unspecified unspecified unspecified unspecified  	O	null

0 ו ו וכותב conjunction unspecified unspecified unspecified unspecified unspecified 0 
0 כותב כתב וכותב verb masculine singular unspecified any beinoni  	O	null

0 את את את at-preposition unspecified unspecified unspecified unspecified unspecified  	O	null

0 ה ה הנשכח definiteArticle unspecified unspecified unspecified unspecified unspecified 0 
0 הנשכח נשכח הנשכח participle masculine singular absolute any unspecified  	O	null

0 אולי אולי אולי adverb unspecified unspecified unspecified unspecified unspecified  	O	null

0 מחר מחר מחר adverb unspecified unspecified unspecified unspecified unspecified  	O	null

0 ה ה החגיגה definiteArticle unspecified unspecified unspecified unspecified unspecified 0 
0 החגיגה חגיגה החגיגה noun feminine singular absolute unspecified unspecified  	O	null

