0 הללי הילל הללי verb feminine singular unspecified 2 imperative  	O	null

0 נפשי נפשי נפשי adjective masculine singular absolute unspecified unspecified  	O	null

0 ל ל לצורך preposition unspecified unspecified unspecified unspecified unspecified 0 
0 צורך צורך לצורך noun masculine singular absolute unspecified unspecified  	O	null

0 שוררי שרר שוררי participle masculine plural construct any unspecified  	O	null

0 ב ב בנעים preposition unspecified unspecified unspecified unspecified unspecified 0 
0 ה ה בנעים definiteArticle unspecified unspecified unspecified unspecified unspecified 0 
0 הנעים נעים בנעים adjective masculine singular absolute unspecified unspecified  	O	null

0 זמיר זמיר זמירך noun masculine singular absolute unspecified unspecified  
0 ך ך זמירך possessive feminine singular unspecified 2 unspecified 0 	O	null

0 עת עת עת noun feminine singular construct unspecified unspecified  	O	null

0 ב ב בכל preposition unspecified unspecified unspecified unspecified unspecified 0 
0 כל כול בכל quantifier unspecified unspecified construct unspecified unspecified  	O	null

0 לשון לשון לשון noun feminine singular construct unspecified unspecified  	O	null

0 תברך בירך תברך verb feminine singular unspecified 3 future  	O	null

0 צור צור צור properName unspecified unspecified unspecified unspecified unspecified  	I_PERS	null

0 אשר אשר אשר properName masculine singular unspecified unspecified unspecified  	I_PERS	null

0 ה ה האציל definiteArticle unspecified unspecified unspecified unspecified unspecified 0 
0 האציל אציל האציל noun masculine singular absolute unspecified unspecified  	O	null

0 כתרים כתר כתרים noun masculine plural absolute unspecified unspecified  	O	null

