0 כאן כאן כאן adverb unspecified unspecified unspecified unspecified unspecified  	O	null

0 לא לא לא negation unspecified unspecified unspecified unspecified unspecified  	O	null

0 אשמע שמע אשמע verb masculine-and-feminine singular unspecified 1 future  	O	null

0 את את את at-preposition unspecified unspecified unspecified unspecified unspecified  	O	null

0 קול קול קול noun masculine singular construct unspecified unspecified  	O	null

0 ה ה הקוקיה definiteArticle unspecified unspecified unspecified unspecified unspecified 0 
0 הקוקיה קוקייה הקוקיה noun feminine singular absolute unspecified unspecified  	O	null

0 כאן כאן כאן adverb unspecified unspecified unspecified unspecified unspecified  	O	null

0 לא לא לא negation unspecified unspecified unspecified unspecified unspecified  	O	null

0 יחבוש חבש יחבוש verb masculine singular unspecified 3 future  	O	null

0 ה ה העץ definiteArticle unspecified unspecified unspecified unspecified unspecified 0 
0 העץ עץ העץ noun masculine singular absolute unspecified unspecified  	O	null

0 מצנפת מצנפת מצנפת noun feminine singular construct unspecified unspecified  	O	null

0 שלג שלג שלג noun masculine singular absolute unspecified unspecified  	O	null

0 אבל אבל אבל conjunction unspecified unspecified unspecified unspecified unspecified  	O	null

0 בצל בצל בצל noun masculine singular absolute unspecified unspecified  	O	null

0 ה ה האורנים definiteArticle unspecified unspecified unspecified unspecified unspecified 0 
0 האורנים אורן האורנים noun masculine plural absolute unspecified unspecified  	O	null

0 ה ה האלה definiteArticle unspecified unspecified unspecified unspecified unspecified 0 
0 האלה אל האלה noun feminine singular absolute unspecified unspecified  	O	null

0 כל כול כל quantifier unspecified unspecified construct unspecified unspecified  	O	null

0 ילדותי ילדותי ילדותי adjective masculine singular absolute unspecified unspecified  	O	null

0 שקמה שקמה שקמה noun feminine singular absolute unspecified unspecified  	O	null

0 ל ל לתחיה preposition unspecified unspecified unspecified unspecified unspecified 0 
0 תחיה תחייה לתחיה noun feminine singular absolute unspecified unspecified  	O	null

0 צלצול צלצול צלצול noun masculine singular absolute unspecified unspecified  	O	null

0 ה ה המחטים definiteArticle unspecified unspecified unspecified unspecified unspecified 0 
0 המחטים מחט המחטים noun feminine plural absolute unspecified unspecified  	O	null

0 היה הוא היה copula masculine singular unspecified 3 past  	O	null

0 היה הוא היה copula masculine singular unspecified 3 past  	O	null

0 אקרא קרא אקרא verb masculine-and-feminine singular unspecified 1 future  	O	null

0 מולדת מולדת מולדת properName unspecified unspecified unspecified unspecified unspecified  	I_PERS	null

0 ל ל למרחב preposition unspecified unspecified unspecified unspecified unspecified 0 
0 מרחב מרחב למרחב noun masculine singular construct unspecified unspecified  	O	null

0 ה ה השלג definiteArticle unspecified unspecified unspecified unspecified unspecified 0 
0 השלג שלג השלג noun masculine singular absolute unspecified unspecified  	O	null

0 ל ל לקרח preposition unspecified unspecified unspecified unspecified unspecified 0 
0 קרח קרח לקרח noun masculine singular absolute unspecified unspecified  	O	null

0 ירקרק ירקרק ירקרק adjective masculine singular absolute unspecified unspecified  	O	null

0 כובל כבל כובל verb masculine singular unspecified any beinoni  	O	null

0 ה ה הפלג definiteArticle unspecified unspecified unspecified unspecified unspecified 0 
0 הפלג פלג הפלג noun masculine singular absolute unspecified unspecified  	O	null

0 ל ל ללשון preposition unspecified unspecified unspecified unspecified unspecified 0 
0 לשון לשון ללשון noun feminine singular construct unspecified unspecified  	O	null

0 ה ה השיר definiteArticle unspecified unspecified unspecified unspecified unspecified 0 
0 השיר שיר השיר noun masculine singular absolute unspecified unspecified  	O	null

0 ב ב בארץ preposition unspecified unspecified unspecified unspecified unspecified 0 
0 ארץ ארץ בארץ noun feminine singular construct unspecified unspecified  	O	null

0 נכריה נכרי נכריה adjective feminine singular absolute unspecified unspecified  	O	null

0 I I I foreign unspecified unspecified unspecified unspecified unspecified  	I_ORG	null

0 remember remember remember foreign unspecified unspecified unspecified unspecified unspecified  	I_ORG	null

0 those those those foreign unspecified unspecified unspecified unspecified unspecified  	I_ORG	null

0 snow-capped snow-capped snow-capped foreign unspecified unspecified unspecified unspecified unspecified  	I_ORG	null

0 mountains mountains mountains foreign unspecified unspecified unspecified unspecified unspecified  	I_ORG	null

0 and and and foreign unspecified unspecified unspecified unspecified unspecified  	I_ORG	null

0 a a a foreign unspecified unspecified unspecified unspecified unspecified  	I_ORG	null

0 song song song foreign unspecified unspecified unspecified unspecified unspecified  	I_ORG	null

0 on on on foreign unspecified unspecified unspecified unspecified unspecified  	I_ORG	null

0 FM FM FM foreign unspecified unspecified unspecified unspecified unspecified  	I_ORG	null

0 ###NUMBER### ###NUMBER### ###NUMBER### numeral unspecified unspecified unspecified unspecified unspecified  	O	null

0 oh oh oh foreign unspecified unspecified unspecified unspecified unspecified  	I_ORG	null

0 my my my foreign unspecified unspecified unspecified unspecified unspecified  	I_ORG	null

0 darlin darlin darlin foreign unspecified unspecified unspecified unspecified unspecified  	I_ORG	null

0 I I I foreign unspecified unspecified unspecified unspecified unspecified  	I_ORG	null

0 have have have foreign unspecified unspecified unspecified unspecified unspecified  	I_ORG	null

0 grown grown grown foreign unspecified unspecified unspecified unspecified unspecified  	I_ORG	null

0 with with with foreign unspecified unspecified unspecified unspecified unspecified  	I_ORG	null

0 you you you foreign unspecified unspecified unspecified unspecified unspecified  	I_ORG	null

0 but but but foreign unspecified unspecified unspecified unspecified unspecified  	I_ORG	null

0 my my my foreign unspecified unspecified unspecified unspecified unspecified  	I_ORG	null

0 roots roots roots foreign unspecified unspecified unspecified unspecified unspecified  	I_ORG	null

0 on on on foreign unspecified unspecified unspecified unspecified unspecified  	I_ORG	null

0 both both both foreign unspecified unspecified unspecified unspecified unspecified  	I_ORG	null

0 sides sides sides foreign unspecified unspecified unspecified unspecified unspecified  	I_ORG	null

0 of of of foreign unspecified unspecified unspecified unspecified unspecified  	I_ORG	null

0 the the the foreign unspecified unspecified unspecified unspecified unspecified  	I_ORG	null

0 sea sea sea foreign unspecified unspecified unspecified unspecified unspecified  	I_ORG	null

0 אולי אולי אולי adverb unspecified unspecified unspecified unspecified unspecified  	O	null

0 רק רק רק conjunction unspecified unspecified unspecified unspecified unspecified  	O	null

0 ציפורי ציפור ציפורי noun masculine plural construct unspecified unspecified  	O	null

0 מסע מסע מסע noun masculine singular construct unspecified unspecified  	O	null

0 יודעות ידע יודעות verb feminine plural unspecified any beinoni  	O	null

0 כש כש כשהן temporalSubConj unspecified unspecified unspecified unspecified unspecified 0 
0 הן הן כשהן adverb unspecified unspecified unspecified unspecified unspecified  	O	null

0 תלויות תלות תלויות noun feminine plural absolute unspecified unspecified  	O	null

0 בין בין בין preposition unspecified unspecified unspecified unspecified unspecified  	O	null

0 ארץ ארץ ארץ noun feminine singular construct unspecified unspecified  	O	null

0 ו ו ושמים conjunction unspecified unspecified unspecified unspecified unspecified 0 
0 שמים שמי ושמים noun masculine plural absolute unspecified unspecified  	O	null

0 את את את at-preposition unspecified unspecified unspecified unspecified unspecified  	O	null

0 זה זה זה pronoun masculine singular unspecified 3 unspecified  	O	null

0 ה ה הכאב definiteArticle unspecified unspecified unspecified unspecified unspecified 0 
0 הכאב כאב הכאב noun masculine singular absolute unspecified unspecified  	I_DATE	null

0 של של של shel-preposition unspecified unspecified unspecified unspecified unspecified  	O	null

0 שתי CARD2 שתי numeral feminine dual construct unspecified unspecified  	O	null

0 ה ה המולדות definiteArticle unspecified unspecified unspecified unspecified unspecified 0 
0 המולדות מולדת המולדות noun feminine plural absolute unspecified unspecified  	O	null

0 את את איתכם at-preposition unspecified unspecified unspecified unspecified unspecified  
0 כם כם איתכם pronomial masculine plural unspecified 2 unspecified 0 	O	null

0 אני הוא אני pronoun masculine-and-feminine singular unspecified 1 unspecified  	O	null

0 נשתלתי נשתל נשתלתי verb masculine-and-feminine singular unspecified 1 past  	O	null

0 פעמים פעם פעמים noun feminine plural absolute unspecified unspecified  	O	null

0 את את איתכם at-preposition unspecified unspecified unspecified unspecified unspecified  
0 כם כם איתכם pronomial masculine plural unspecified 2 unspecified 0 	O	null

0 אני הוא אני pronoun masculine-and-feminine singular unspecified 1 unspecified  	O	null

0 צמחתי צמח צמחתי verb masculine-and-feminine singular unspecified 1 past  	O	null

0 ארנים ארנים ארנים properName masculine singular unspecified unspecified unspecified  	O	null

0 ו ו ושורשי conjunction unspecified unspecified unspecified unspecified unspecified 0 
0 שורשי שורש ושורשי noun masculine plural construct unspecified unspecified  	O	null

0 ב ב בשני preposition unspecified unspecified unspecified unspecified unspecified 0 
0 שני שני בשני noun masculine singular absolute unspecified unspecified  	O	null

0 נופים נוף נופים noun masculine plural absolute unspecified unspecified  	O	null

0 שונים שונה שונים adjective masculine plural absolute unspecified unspecified  	O	null

