0 שיר שיר שיר noun masculine singular absolute unspecified unspecified  	O	null

0 קטן קטן קטן adjective masculine singular absolute unspecified unspecified  	O	null

0 מתנגן התנגן מתנגן verb masculine singular unspecified any beinoni  	O	null

0 ב ב בבוקר preposition unspecified unspecified unspecified unspecified unspecified 0 
0 בוקר בוקר בבוקר noun masculine singular absolute unspecified unspecified  	O	null

0 as as as foreign unspecified unspecified unspecified unspecified unspecified  	I_ORG	null

0 the the the foreign unspecified unspecified unspecified unspecified unspecified  	I_ORG	null

0 day day day foreign unspecified unspecified unspecified unspecified unspecified  	I_ORG	null

0 begins begins begins foreign unspecified unspecified unspecified unspecified unspecified  	I_ORG	null

0 שיר שיר שיר noun masculine singular absolute unspecified unspecified  	O	null

0 מואר מואר מואר adjective masculine singular absolute unspecified unspecified  	O	null

0 עוד עוד עוד adverb unspecified unspecified unspecified unspecified unspecified  	O	null

0 דקה דקה דקה noun feminine singular absolute unspecified unspecified  	O	null

0 חדשות חדשה חדשות noun feminine plural absolute unspecified unspecified  	O	null

0 נקווה נקווה נקווה verb masculine singular unspecified any beinoni  	O	null

0 ש ש שזה relativizer/subordinatingConjunction unspecified unspecified unspecified unspecified unspecified 0 
0 זה זה שזה pronoun masculine singular unspecified 3 unspecified  	O	null

0 יהיה הוא יהיה copula masculine singular unspecified 3 future  	O	null

0 good good good foreign unspecified unspecified unspecified unspecified unspecified  	I_ORG	null

0 morning morning morning foreign unspecified unspecified unspecified unspecified unspecified  	I_ORG	null

0 good good good foreign unspecified unspecified unspecified unspecified unspecified  	I_ORG	null

0 morning morning morning foreign unspecified unspecified unspecified unspecified unspecified  	I_ORG	null

