0 אמר אמר אמר verb masculine singular unspecified 3 past  	O	null

0 רבי רבי רבי noun masculine singular construct unspecified unspecified  	O	null

0 עקיבא עקיבא עקיבא properName unspecified unspecified unspecified unspecified unspecified  	I_PERS	null

0 אשרי אשרי אשריכם interjection unspecified unspecified unspecified unspecified unspecified  
0 כם כם אשריכם pronomial masculine plural unspecified 2 unspecified 0 	O	null

0 ישראל ישראל ישראל properName unspecified unspecified unspecified unspecified unspecified  	I_PERS	null

0 לפני לפני לפני preposition unspecified unspecified unspecified unspecified unspecified  	O	null

0 מי מי מי interrogative unspecified unspecified unspecified unspecified unspecified  	O	null

0 את את אתם at-preposition unspecified unspecified unspecified unspecified unspecified  
0 הם הם אתם pronomial masculine plural unspecified 3 unspecified 0 	O	null

0 מטהרים טיהר מטהרים verb masculine plural unspecified any beinoni  	O	null

0 ו ו ומי conjunction unspecified unspecified unspecified unspecified unspecified 0 
0 מי מי ומי interrogative unspecified unspecified unspecified unspecified unspecified  	O	null

0 מטהר טיהר מטהר verb masculine singular unspecified any beinoni  	O	null

0 את את אתכם at-preposition unspecified unspecified unspecified unspecified unspecified  
0 כם כם אתכם pronomial masculine plural unspecified 2 unspecified 0 	O	null

0 אבי אב אביכם noun masculine singular absolute unspecified unspecified  
0 כם כם אביכם possessive masculine plural unspecified 2 unspecified 0 	O	null

0 ש ש שבשמיים relativizer/subordinatingConjunction unspecified unspecified unspecified unspecified unspecified 0 
0 בשמיים בשמיים שבשמיים adverb unspecified unspecified unspecified unspecified unspecified  	O	null

