0 מילות מילה מילות noun feminine plural construct unspecified unspecified  	O	null

0 ה ה השיר definiteArticle unspecified unspecified unspecified unspecified unspecified 0 
0 השיר שיר השיר noun masculine singular absolute unspecified unspecified  	O	null

0 את את את at-preposition unspecified unspecified unspecified unspecified unspecified  	O	null

0 ב ב במרחבים preposition unspecified unspecified unspecified unspecified unspecified 0 
0 מרחבים מרחב במרחבים noun masculine plural absolute unspecified unspecified  	O	null

0 מתוך מתוך מתוך preposition unspecified unspecified unspecified unspecified unspecified  	O	null

0 כאב כאב כאב noun masculine singular absolute unspecified unspecified  	I_DATE	null

0 גדול גדול גדול adjective masculine singular absolute unspecified unspecified  	O	null

0 נשארת נשאר נשארת verb feminine singular unspecified any beinoni  	O	null

0 השלמה השלמה השלמה noun feminine singular absolute unspecified unspecified  	O	null

0 מתוך מתוך מתוך preposition unspecified unspecified unspecified unspecified unspecified  	O	null

0 ה ה השאלות definiteArticle unspecified unspecified unspecified unspecified unspecified 0 
0 השאלות שאלה השאלות noun feminine plural absolute unspecified unspecified  	O	null

0 ה ה התהיות definiteArticle unspecified unspecified unspecified unspecified unspecified 0 
0 התהיות תהייה התהיות noun feminine plural absolute unspecified unspecified  	O	null

0 ו ו והפחדים conjunction unspecified unspecified unspecified unspecified unspecified 0 
0 ה ה והפחדים definiteArticle unspecified unspecified unspecified unspecified unspecified 0 
0 הפחדים פחד והפחדים noun masculine plural absolute unspecified unspecified  	O	null

0 נשארת נשאר נשארת verb feminine singular unspecified any beinoni  	O	null

0 השלמה השלמה השלמה noun feminine singular absolute unspecified unspecified  	O	null

0 המראת המראה המראת noun feminine singular construct unspecified unspecified  	O	null

0 מעל מעל מעל preposition unspecified unspecified unspecified unspecified unspecified  	O	null

0 ה ה הכל definiteArticle unspecified unspecified unspecified unspecified unspecified 0 
0 הכל כול הכל quantifier unspecified unspecified unspecified unspecified unspecified  	O	null

0 פרשת פרשה פרשת noun feminine singular construct unspecified unspecified  	O	null

0 כנפיים כנפיים כנפיים properName unspecified unspecified unspecified unspecified unspecified  	I_ORG	null

0 חזרת חזרה חזרת noun feminine singular construct unspecified unspecified  	O	null

0 אל אל אל preposition unspecified unspecified unspecified unspecified unspecified  	O	null

0 ה ה המקור definiteArticle unspecified unspecified unspecified unspecified unspecified 0 
0 המקור מקור המקור noun masculine singular absolute unspecified unspecified  	O	null

0 אין יש אין existential unspecified unspecified unspecified unspecified unspecified  	O	null

0 כבר כבר כבר adverb unspecified unspecified unspecified unspecified unspecified  	O	null

0 שאלות שאלה שאלות noun feminine plural absolute unspecified unspecified  	O	null

0 בלי בלי בלי preposition unspecified unspecified unspecified unspecified unspecified  	O	null

0 ל ל לדעת preposition unspecified unspecified unspecified unspecified unspecified 0 
0 דעת דעה לדעת noun feminine singular construct unspecified unspecified  	O	null

0 למה לאמה למה noun feminine singular absolute unspecified unspecified  	O	null

0 בלי בלי בלי preposition unspecified unspecified unspecified unspecified unspecified  	O	null

0 ל ל לדעת preposition unspecified unspecified unspecified unspecified unspecified 0 
0 דעת דעה לדעת noun feminine singular construct unspecified unspecified  	O	null

0 ל ל לאן preposition unspecified unspecified unspecified unspecified unspecified 0 
0 אן אן לאן properName unspecified unspecified unspecified unspecified unspecified  	I_PERS	null

0 את את את at-preposition unspecified unspecified unspecified unspecified unspecified  	O	null

0 הולכת הולכה הולכת noun feminine singular construct unspecified unspecified  	O	null

0 שלמה שלמה שלמה properName unspecified unspecified unspecified unspecified unspecified  	I_PERS	null

