0 זה זה זה pronoun masculine singular unspecified 3 unspecified  	O	null

0 נעים נעים נעים properName masculine singular unspecified unspecified unspecified  	I_PERS	null

0 ב ב בערב preposition unspecified unspecified unspecified unspecified unspecified 0 
0 ערב ערב בערב noun masculine singular absolute unspecified unspecified  	O	null

0 אביב אביב אביב properName unspecified unspecified unspecified unspecified unspecified  	I_PERS	null

0 לטייל טייל לטייל verb unspecified unspecified unspecified unspecified infinitive  	O	null

0 בלי בלי בלי preposition unspecified unspecified unspecified unspecified unspecified  	O	null

0 מטרה מטרה מטרה noun feminine singular absolute unspecified unspecified  	O	null

0 להביט הביט להביט verb unspecified unspecified unspecified unspecified infinitive  	O	null

0 קצת קצת קצת adverb unspecified unspecified unspecified unspecified unspecified  	O	null

0 מסביב מסביב מסביב adverb unspecified unspecified unspecified unspecified unspecified  	O	null

0 ו ו ולפגוש conjunction unspecified unspecified unspecified unspecified unspecified 0 
0 לפגוש פגש ולפגוש verb unspecified unspecified unspecified unspecified infinitive  	O	null

0 חברים חבר חברים noun masculine plural absolute unspecified unspecified  	O	null

0 ב ב בשדרה preposition unspecified unspecified unspecified unspecified unspecified 0 
0 ה ה בשדרה definiteArticle unspecified unspecified unspecified unspecified unspecified 0 
0 השדרה שדרה בשדרה noun feminine singular absolute unspecified unspecified  	O	null

0 ישראל ישראל ישראל properName unspecified unspecified unspecified unspecified unspecified  	I_PERS	null

0 של של שלי shel-preposition unspecified unspecified unspecified unspecified unspecified  
0 י י שלי pronomial masculine-and-feminine singular unspecified 1 unspecified 0 	O	null

0 הישנשנה הישנשנה הישנשנה verb feminine plural unspecified 2 future  	O	null

0 שאף שאף שאף noun masculine singular absolute unspecified unspecified  	O	null

0 פעם פעם פעם noun feminine singular absolute unspecified unspecified  	O	null

0 אינה אינה אינה verb masculine singular unspecified 3 past  	O	null

0 משתנה משתנה משתנה noun masculine singular absolute unspecified unspecified  	O	null

