0 מר מר מר adverb unspecified unspecified unspecified unspecified unspecified  	O	null

0 ל ל לי preposition unspecified unspecified unspecified unspecified unspecified  
0 י י לי pronomial masculine-and-feminine singular unspecified 1 unspecified 0 	O	null

0 מר מר מר adverb unspecified unspecified unspecified unspecified unspecified  	O	null

0 ליבי ליבי ליבי properName unspecified unspecified unspecified unspecified unspecified  	I_PERS	null

0 היום היום היום adverb unspecified unspecified unspecified unspecified unspecified  	O	null

0 על על עלי preposition unspecified unspecified unspecified unspecified unspecified  
0 י י עלי pronomial masculine-and-feminine singular unspecified 1 unspecified 0 	O	null

0 רע רע רע noun masculine singular absolute unspecified unspecified  	O	null

0 אם אם אם conjunction unspecified unspecified unspecified unspecified unspecified  	O	null

0 רחל רחל רחלה noun feminine singular absolute unspecified unspecified  
0 ה ה רחלה possessive feminine singular unspecified 3 unspecified 0 	O	null

0 איננה הוא איננה copula feminine singular unspecified 3 beinoni  	O	null

0 אני הוא אני pronoun masculine-and-feminine singular unspecified 1 unspecified  	O	null

0 אנה אנה אנה properName unspecified unspecified unspecified unspecified unspecified  	I_PERS	null

0 בא בא בא verb masculine singular unspecified 3 past  	O	null

0 פה פה פה adverb unspecified unspecified unspecified unspecified unspecified  	O	null

0 יש יש יש existential unspecified unspecified unspecified unspecified unspecified  	O	null

0 ל ל לבריות preposition unspecified unspecified unspecified unspecified unspecified 0 
0 ה ה לבריות definiteArticle unspecified unspecified unspecified unspecified unspecified 0 
0 הבריות ברייה לבריות noun feminine plural absolute unspecified unspecified  	O	null

0 ו ו והולכות conjunction unspecified unspecified unspecified unspecified unspecified 0 
0 הולכות הולכה והולכות noun feminine plural absolute unspecified unspecified  	O	null

0 הן הן הן conjunction unspecified unspecified unspecified unspecified unspecified  	O	null

0 רכיל רכיל רכיל noun masculine singular absolute unspecified unspecified  	O	null

0 אך אך אך conjunction unspecified unspecified unspecified unspecified unspecified  	O	null

0 רחל רחל רחלה noun feminine singular absolute unspecified unspecified  
0 ה ה רחלה possessive feminine singular unspecified 3 unspecified 0 	O	null

0 ל ל לי preposition unspecified unspecified unspecified unspecified unspecified  
0 י י לי pronomial masculine-and-feminine singular unspecified 1 unspecified 0 	O	null

0 היא הוא היא pronoun feminine singular unspecified 3 unspecified  	O	null

0 ו ו ואנוכי conjunction unspecified unspecified unspecified unspecified unspecified 0 
0 אנוכי אנוכי ואנוכי adjective masculine singular absolute unspecified unspecified  	O	null

0 ל ל לרחל preposition unspecified unspecified unspecified unspecified unspecified 0 
0 רחל רחל לרחל properName feminine singular unspecified unspecified unspecified  	I_PERS	null

