0 ב ב ברגומי preposition unspecified unspecified unspecified unspecified unspecified 0 
0 רגומי רגם ברגומי participle masculine plural construct any unspecified  	O	null

0 ב ב בארזי preposition unspecified unspecified unspecified unspecified unspecified 0 
0 ארזי ארז בארזי noun masculine plural construct unspecified unspecified  	O	null

0 אנץ אנץ אנצ noun feminine singular construct unspecified unspecified  	O	null

0 לוטי לוט לוטי noun masculine plural construct unspecified unspecified  	O	null

0 דונאדוני דונאדוני דונאדוני noun masculine plural construct unspecified unspecified  	O	null

0 קאניג קאניג קאניג noun masculine singular construct unspecified unspecified  	O	null

0 ה ה ה definiteArticle unspecified unspecified unspecified unspecified unspecified 0 	O	null

0 ב ב בורוצ preposition unspecified unspecified unspecified unspecified unspecified 0 
0 ורו ורו בורוצ noun masculine singular absolute unspecified unspecified  
0 ה ה בורוצ possessive feminine singular unspecified 3 unspecified 0 	O	null

0 אגה נגה אגה verb masculine-and-feminine singular unspecified 1 future  	O	null

0 באסוואלדו באסוואלדו באסוואלדו properName unspecified unspecified unspecified unspecified unspecified  	O	null

0 מראדונה מראדונה מראדונה properName unspecified unspecified unspecified unspecified unspecified  	I_PERS	null

0 רינקון רינקון רינקון properName unspecified unspecified unspecified unspecified unspecified  	O	null

0 רדין רדין רדין noun masculine singular construct unspecified unspecified  	O	null

0 איגוארן איגוארן איגוארן noun feminine plural absolute unspecified unspecified  	O	null

0 אסטראדה אסטראדה אסטראדה properName unspecified unspecified unspecified unspecified unspecified  	O	null

0 ו ו והיגיטה conjunction unspecified unspecified unspecified unspecified unspecified 0 
0 ה ה והיגיטה definiteArticle unspecified unspecified unspecified unspecified unspecified 0 
0 היגיטה היגיטה והיגיטה noun feminine singular absolute unspecified unspecified  	O	null

0 בוץ בוץ בוצ properName unspecified unspecified unspecified unspecified unspecified  	O	null

0 ר ר ר properName unspecified unspecified unspecified unspecified unspecified  	O	null

0 פארקר פארקר פארקר properName unspecified unspecified unspecified unspecified unspecified  	I_PERS	null

0 ווקר ווקר ווקר properName unspecified unspecified unspecified unspecified unspecified  	O	null

0 פירס פירס פירס properName unspecified unspecified unspecified unspecified unspecified  	O	null

0 רובסון רובסון רובסון properName unspecified unspecified unspecified unspecified unspecified  	O	null

0 גסקוין גסקוין גסקוין properName unspecified unspecified unspecified unspecified unspecified  	O	null

0 שילטון שלטון שילטון noun masculine singular absolute unspecified unspecified  	O	null

0 אנדרינואה אנדרינואה אנדרינואה noun feminine singular absolute unspecified unspecified  	O	null

0 אילרויה אילרויה אילרויה properName unspecified unspecified unspecified unspecified unspecified  	O	null

0 ואסקז ואסקז ואסקז properName unspecified unspecified unspecified unspecified unspecified  	O	null

0 פרנץ פרנץ פרנצ properName unspecified unspecified unspecified unspecified unspecified  	O	null

0 סקולי סקול סקולי adjective masculine plural construct unspecified unspecified  	O	null

0 זנגה זנגה זנגה properName unspecified unspecified unspecified unspecified unspecified  	O	null

0 קלינסמן קלינסמן קלינסמן properName unspecified unspecified unspecified unspecified unspecified  	O	null

0 מגנוסון מגנוסון מגנוסון properName unspecified unspecified unspecified unspecified unspecified  	O	null

0 גלואו גלואו גלואו properName unspecified unspecified unspecified unspecified unspecified  	O	null

0 סילאס סילאס סילאס properName unspecified unspecified unspecified unspecified unspecified  	O	null

0 ברולין ברולין ברולין properName unspecified unspecified unspecified unspecified unspecified  	O	null

0 ו ו ואן conjunction unspecified unspecified unspecified unspecified unspecified 0 
0 אן אן ואן properName unspecified unspecified unspecified unspecified unspecified  	I_PERS	null
1 - - - punctuation unspecified unspecified unspecified unspecified unspecified  	O	null
2 טיחלן טיחלן טיחלן properName unspecified unspecified unspecified unspecified unspecified  	I_ORG	null

0 ו ו ואן conjunction unspecified unspecified unspecified unspecified unspecified 0 
0 אן אן ואן properName unspecified unspecified unspecified unspecified unspecified  	I_PERS	null
1 - - - punctuation unspecified unspecified unspecified unspecified unspecified  	O	null
2 ברוקלן ברוקלן ברוקלן properName unspecified unspecified unspecified unspecified unspecified  	I_ORG	null

0 ו ו ואן conjunction unspecified unspecified unspecified unspecified unspecified 0 
0 אן אן ואן properName feminine singular unspecified unspecified unspecified  	I_PERS	null
1 - - - punctuation unspecified unspecified unspecified unspecified unspecified  	O	null
2 שחיף שחיף שחיף properName unspecified unspecified unspecified unspecified unspecified  	I_ORG	null

0 ו ו וים conjunction unspecified unspecified unspecified unspecified unspecified 0 
0 ים ים וים noun masculine singular absolute unspecified unspecified  	O	null

0 קיפט קיפט קיפט noun masculine singular construct unspecified unspecified  	O	null

0 ו ו ואן conjunction unspecified unspecified unspecified unspecified unspecified 0 
0 אן אן ואן properName unspecified unspecified unspecified unspecified unspecified  	I_PERS	null

0 באסטן באסטן באסטן properName unspecified unspecified unspecified unspecified unspecified  	O	null

0 מקויסט מקויסט מקויסט noun masculine singular absolute unspecified unspecified  	O	null

0 מקליש הקליש מקליש verb masculine singular unspecified any beinoni  	O	null

0 מ מ מקסטיי preposition unspecified unspecified unspecified unspecified unspecified 0 
0 קסטיי קסטיי מקסטיי noun masculine singular construct unspecified unspecified  	O	null

0 ו ו ומלפאס conjunction unspecified unspecified unspecified unspecified unspecified 0 
0 מ מ ומלפאס preposition unspecified unspecified unspecified unspecified unspecified 0 
0 לפאס לפאס ומלפאס noun masculine singular absolute unspecified unspecified  	O	null

0 מקינלי מקינלי מקינלי properName unspecified unspecified unspecified unspecified unspecified  	O	null

0 ג ג ג properName unspecified unspecified unspecified unspecified unspecified  	O	null

0 ונסטון ונסטון ונסטון properName unspecified unspecified unspecified unspecified unspecified  	O	null

0 רוב רוב רובן noun masculine singular absolute unspecified unspecified  
0 ן ן רובן possessive feminine plural unspecified 3 unspecified 0 	O	null

0 פאס פאס פאס properName unspecified unspecified unspecified unspecified unspecified  	O	null

0 ו ו ורובן conjunction unspecified unspecified unspecified unspecified unspecified 0 
0 רוב רוב ורובן noun masculine singular absolute unspecified unspecified  
0 ן ן ורובן possessive feminine plural unspecified 3 unspecified 0 	O	null

0 סוס סוס סוסה noun masculine singular absolute unspecified unspecified  
0 ה ה סוסה possessive feminine singular unspecified 3 unspecified 0 	O	null

0 רוב רוב רובן noun masculine singular absolute unspecified unspecified  
0 ן ן רובן possessive feminine plural unspecified 3 unspecified 0 	O	null

0 פררה פירר פררה verb feminine singular unspecified 3 past  	O	null

0 דה דה דה properName unspecified unspecified unspecified unspecified unspecified  	I_PERS	null

0 ליאון ליאון ליאון properName unspecified unspecified unspecified unspecified unspecified  	I_PERS	null

0 דומינגז דומינגז דומינגז noun masculine singular construct unspecified unspecified  	O	null

0 פרדומו פרדומו פרדומו properName unspecified unspecified unspecified unspecified unspecified  	O	null

0 ו ו והררה conjunction unspecified unspecified unspecified unspecified unspecified 0 
0 הררה הררה והררה properName feminine singular unspecified unspecified unspecified  	I_LOC	null

0 ברנקו ברנקו ברנקו properName unspecified unspecified unspecified unspecified unspecified  	O	null

0 דונג דונג דונגה noun masculine singular absolute unspecified unspecified  
0 ה ה דונגה possessive feminine singular unspecified 3 unspecified 0 	O	null

0 אלמאו אלמאו אלמאו noun masculine singular absolute unspecified unspecified  	O	null

0 ריקרדו ריקרדו ריקרדו properName unspecified unspecified unspecified unspecified unspecified  	O	null

0 וקארקה וקארקה וקארקה properName unspecified unspecified unspecified unspecified unspecified  	O	null

0 ויטסחה ויטסחה ויטסחה properName unspecified unspecified unspecified unspecified unspecified  	O	null

0 קומאן קומאן קומאן properName unspecified unspecified unspecified unspecified unspecified  	O	null

0 חוליט חוליט חוליט properName unspecified unspecified unspecified unspecified unspecified  	O	null

0 אלסמנדי אלסמנדי אלסמנדי properName unspecified unspecified unspecified unspecified unspecified  	O	null

0 ופונסקה ופונסקה ופונסקה properName unspecified unspecified unspecified unspecified unspecified  	O	null

0 חידיאטולין חידיאטולין חידיאטולין properName unspecified unspecified unspecified unspecified unspecified  	O	null

0 אליניקוב אליניקוב אליניקוב properName unspecified unspecified unspecified unspecified unspecified  	O	null

0 זבארוב זבארוב זבארוב participle feminine plural construct any unspecified  	O	null

0 ופרוטאסוב ופרוטאסוב ופרוטאסוב properName unspecified unspecified unspecified unspecified unspecified  	O	null

0 באלבו באלבו באלבו properName unspecified unspecified unspecified unspecified unspecified  	O	null

0 ג ג ג properName unspecified unspecified unspecified unspecified unspecified  	O	null

0 וסטי וסט וסטי noun masculine plural construct unspecified unspecified  	O	null

0 אוב אוב אובה noun masculine singular absolute unspecified unspecified  
0 ה ה אובה possessive feminine singular unspecified 3 unspecified 0 	O	null

0 ב ב ביין preposition unspecified unspecified unspecified unspecified unspecified 0 
0 יין יין ביין noun masculine singular absolute unspecified unspecified  	O	null

0 קונחו קונחו קונחו verb masculine-and-feminine plural unspecified 3 past  	O	null

0 וקיאסו וקיאסו וקיאסו properName unspecified unspecified unspecified unspecified unspecified  	O	null

0 אסקובאר אסקובאר אסקובאר properName unspecified unspecified unspecified unspecified unspecified  	O	null

0 ואלואארז ואלואארז ואלואארז properName unspecified unspecified unspecified unspecified unspecified  	O	null

0 ואולרטיקוץ ואולרטיקוץ ואולרטיקוצ adjective masculine singular construct unspecified unspecified  	O	null

0 אה אה אה interjection unspecified unspecified unspecified unspecified unspecified  	O	null

0 סלינאס סלינאס סלינאס properName unspecified unspecified unspecified unspecified unspecified  	O	null

0 מי מי מיצ noun masculine singular absolute unspecified unspecified  
0 ה ה מיצ possessive feminine singular unspecified 3 unspecified 0 	O	null

0 ל ל ל preposition unspecified unspecified unspecified unspecified unspecified  	O	null

0 בוטרגניו בוטרגניו בוטרגניו properName unspecified unspecified unspecified unspecified unspecified  	O	null

0 וזוביזרטה וזוביזרטה וזוביזרטה verb feminine singular unspecified 2 imperative  	O	null

0 ה ה הסלר definiteArticle unspecified unspecified unspecified unspecified unspecified 0 
0 הסלר הסלר הסלר noun masculine singular absolute unspecified unspecified  	O	null

0 רויטר רויטר רויטר properName unspecified unspecified unspecified unspecified unspecified  	I_ORG	null

0 אוגנטלר אוגנטלר אוגנטלר properName unspecified unspecified unspecified unspecified unspecified  	O	null

0 פלר פלר פלר properName unspecified unspecified unspecified unspecified unspecified  	O	null

0 וליטברסקי וליטברסקי וליטברסקי properName unspecified unspecified unspecified unspecified unspecified  	O	null

0 מ מ מקנקי preposition unspecified unspecified unspecified unspecified unspecified 0 
0 קנק קנק מקנקי noun masculine singular absolute unspecified unspecified  
0 י י מקנקי possessive masculine-and-feminine singular unspecified 1 unspecified 0 	O	null

0 מילה מילה מילה noun feminine singular absolute unspecified unspecified  	O	null

0 ליטוב ליטוב ליטובצ noun masculine singular absolute unspecified unspecified  
0 ו ו ליטובצ possessive masculine singular unspecified 3 unspecified 0 	O	null

0 נקו ניקה נקו verb masculine-and-feminine plural unspecified 2 imperative  	O	null

0 דברבולסקי דברבולסקי דברבולסקי properName unspecified unspecified unspecified unspecified unspecified  	O	null

0 דה דה דה properName unspecified unspecified unspecified unspecified unspecified  	I_PERS	null
1 - - - properName unspecified unspecified unspecified unspecified unspecified  	I_PERS	null
2 נאפולי נאפולי נאפולי properName unspecified unspecified unspecified unspecified unspecified  	I_LOC	null

0 מלדיני מלדיני מלדיני noun masculine plural construct unspecified unspecified  	O	null

0 דאג דאג דאג verb masculine singular unspecified 3 past  	O	null

0 ו ו וסטיני conjunction unspecified unspecified unspecified unspecified unspecified 0 
0 סטין סטין וסטיני noun masculine plural absolute unspecified unspecified  
0 ה ה וסטיני possessive feminine singular unspecified 3 unspecified 0 	O	null

0 קרנאבלה קרנאבלה קרנאבלה verb feminine singular unspecified 2 imperative  	O	null

0 ג ג ג properName unspecified unspecified unspecified unspecified unspecified  	O	null

0 יאניני יאניני יאניני verb feminine singular unspecified 2 imperative  	O	null

0 פרי פרי פרי properName unspecified unspecified unspecified unspecified unspecified  	I_PERS	null

0 ב ב באג preposition unspecified unspecified unspecified unspecified unspecified 0 
0 אג אג באג noun masculine singular absolute unspecified unspecified  	O	null

0 יו יו יו properName unspecified unspecified unspecified unspecified unspecified  	O	null

0 ו ו וסרנה conjunction unspecified unspecified unspecified unspecified unspecified 0 
0 סרן סרן וסרנה noun masculine singular absolute unspecified unspecified  
0 ה ה וסרנה possessive feminine singular unspecified 3 unspecified 0 	O	null

0 וויאלי וויאלי וויאלי properName unspecified unspecified unspecified unspecified unspecified  	O	null

0 מורב מורב מורבצ noun masculine singular absolute unspecified unspecified  
0 ו ו מורבצ possessive masculine singular unspecified 3 unspecified 0 	O	null

0 ק ק ק properName unspecified unspecified unspecified unspecified unspecified  	O	null

0 קוביק קוביק קוביק verb masculine singular unspecified 3 past  	O	null

0 קנופליץ קנופליץ קנופליצ properName unspecified unspecified unspecified unspecified unspecified  	O	null

0 ק ק ק properName unspecified unspecified unspecified unspecified unspecified  	O	null

0 וסקוראבי וסקוראבי וסקוראבי properName unspecified unspecified unspecified unspecified unspecified  	O	null

0 ה ה הסקורר definiteArticle unspecified unspecified unspecified unspecified unspecified 0 
0 הסקורר הסקורר הסקורר noun masculine singular absolute unspecified unspecified  	O	null

0 ש ש שידי relativizer/subordinatingConjunction unspecified unspecified unspecified unspecified unspecified 0 
0 ידי יד שידי noun feminine plural construct unspecified unspecified  	O	null

0 קסקרינו קסקרינו קסקרינו verb masculine-and-feminine plural unspecified 1 past  	O	null

0 קווין קווין קווין properName unspecified unspecified unspecified unspecified unspecified  	I_PERS	null

0 מורא מורא מוראן noun masculine singular absolute unspecified unspecified  
0 ן ן מוראן possessive feminine plural unspecified 3 unspecified 0 	O	null

0 ו ו ופט conjunction unspecified unspecified unspecified unspecified unspecified 0 
0 פט פט ופט noun masculine singular construct unspecified unspecified  	O	null

0 בונר בונר בונר properName unspecified unspecified unspecified unspecified unspecified  	O	null

0 סטויקוביץ סטויקוביץ סטויקוביץ properName unspecified unspecified unspecified unspecified unspecified  	O	null

0 וקטאנץ וקטאנץ וקטאנץ properName unspecified unspecified unspecified unspecified unspecified  	O	null

0 ו ו וסוסיץ conjunction unspecified unspecified unspecified unspecified unspecified 0 
0 סוסיץ סוסיץ וסוסיץ noun masculine singular absolute unspecified unspecified  	O	null

0 - - - punctuation unspecified unspecified unspecified unspecified unspecified  	O	null

0 וויוביץ וויוביץ וויוביץ properName unspecified unspecified unspecified unspecified unspecified  	O	null

0 סטונטון סטונטון סטונטון properName unspecified unspecified unspecified unspecified unspecified  	O	null

0 מוריס מוריס מוריס properName unspecified unspecified unspecified unspecified unspecified  	I_PERS	null

0 סטייפלטון סטייפלטון סטייפלטון properName unspecified unspecified unspecified unspecified unspecified  	O	null

0 אולירי אולירי אולירי noun masculine plural construct unspecified unspecified  	O	null

0 ו ו ויליאן conjunction unspecified unspecified unspecified unspecified unspecified 0 
0 יליאן יליאן ויליאן properName unspecified unspecified unspecified unspecified unspecified  	O	null

0 אולדריג אולדריג אולדריג verb masculine plural unspecified any beinoni  	O	null

0 דה דה דה properName unspecified unspecified unspecified unspecified unspecified  	I_PERS	null
1 - - - punctuation unspecified unspecified unspecified unspecified unspecified  	O	null
2 מול מול מול preposition unspecified unspecified unspecified unspecified unspecified  	I_ORG	null
3 - - - punctuation unspecified unspecified unspecified unspecified unspecified  	I_ORG	null
4 דה דה דה properName unspecified unspecified unspecified unspecified unspecified  	I_LOC	null
5 - - - properName unspecified unspecified unspecified unspecified unspecified  	I_LOC	null
6 וולף וולף וולף properName unspecified unspecified unspecified unspecified unspecified  	I_LOC	null

0 יאן יאן יאן properName unspecified unspecified unspecified unspecified unspecified  	O	null

0 קולמאנס קולמאנס קולמאנס noun masculine singular absolute unspecified unspecified  	O	null

0 ו ו ולקאטוש conjunction unspecified unspecified unspecified unspecified unspecified 0 
0 לקאטוש לקאטוש ולקאטוש noun feminine plural absolute unspecified unspecified  	O	null

0 ו ו והאדג conjunction unspecified unspecified unspecified unspecified unspecified 0 
0 ה ה והאדג definiteArticle unspecified unspecified unspecified unspecified unspecified 0 
0 האדג האדג והאדג noun masculine singular absolute unspecified unspecified  	O	null

0 י י י properName unspecified unspecified unspecified unspecified unspecified  	O	null

0 רומאריו רומאריו רומאריו properName masculine singular unspecified unspecified unspecified  	O	null

0 ובבטו ובבטו ובבטו verb masculine-and-feminine plural unspecified 3 past  	O	null

0 סריסואלה סריסואלה סריסואלה noun masculine singular absolute unspecified unspecified  	O	null

0 ו ו וסקילאצ conjunction unspecified unspecified unspecified unspecified unspecified 0 
0 סקילאץ סקילאץ וסקילאצ adjective masculine singular construct unspecified unspecified  	O	null

0 י י י properName unspecified unspecified unspecified unspecified unspecified  	O	null

0 ג ג ג properName unspecified unspecified unspecified unspecified unspecified  	O	null

0 ורג ורג ורג properName unspecified unspecified unspecified unspecified unspecified  	O	null

0 יניו יניו יניו properName unspecified unspecified unspecified unspecified unspecified  	O	null

0 ו ו ומאזיניו conjunction unspecified unspecified unspecified unspecified unspecified 0 
0 מאזיני מאזין ומאזיניו noun masculine plural absolute unspecified unspecified  
0 ו ו ומאזיניו possessive masculine singular unspecified 3 unspecified 0 	O	null

0 ו ו ואן conjunction unspecified unspecified unspecified unspecified unspecified 0 
0 אן אן ואן properName unspecified unspecified unspecified unspecified unspecified  	I_PERS	null
1 - - - properName unspecified unspecified unspecified unspecified unspecified  	I_PERS	null
2 דר דר דר properName masculine singular unspecified unspecified unspecified  	I_PERS	null
3 - - - properName unspecified unspecified unspecified unspecified unspecified  	I_PERS	null
4 אלסט אלסט אלסט properName unspecified unspecified unspecified unspecified unspecified  	I_PERS	null

0 ו ו וגם conjunction unspecified unspecified unspecified unspecified unspecified 0 
0 גם גם וגם conjunction unspecified unspecified unspecified unspecified unspecified  	O	null

0 דה דה דה properName unspecified unspecified unspecified unspecified unspecified  	I_PERS	null
1 - - - punctuation unspecified unspecified unspecified unspecified unspecified  	O	null
2 חרייזה חרייזה חרייזה properName unspecified unspecified unspecified unspecified unspecified  	I_ORG	null

0 אל אל אל preposition unspecified unspecified unspecified unspecified unspecified  	O	null

0 אוי אוי אוי interjection unspecified unspecified unspecified unspecified unspecified  	O	null

0 ל ל לי preposition unspecified unspecified unspecified unspecified unspecified  
0 י י לי pronomial masculine-and-feminine singular unspecified 1 unspecified 0 	O	null

0 עם עם עם preposition unspecified unspecified unspecified unspecified unspecified  	O	null

0 ה ה השם definiteArticle unspecified unspecified unspecified unspecified unspecified 0 
0 השם שם השם noun masculine singular absolute unspecified unspecified  	O	null

0 הזה הזה הזה verb masculine singular unspecified 3 past  	O	null

0 שום שום שום quantifier unspecified unspecified construct unspecified unspecified  	O	null

0 שם שם שם adverb unspecified unspecified unspecified unspecified unspecified  	O	null

0 לא לא לא negation unspecified unspecified unspecified unspecified unspecified  	O	null

0 מתחרייזה מתחרייזה מתחרייזה verb feminine singular unspecified any beinoni  	O	null

0 אז אז אז conjunction unspecified unspecified unspecified unspecified unspecified  	O	null

0 מה מה מה interrogative unspecified unspecified unspecified unspecified unspecified  	O	null

0 אומר אמר אומר verb masculine singular unspecified any beinoni  	O	null

0 אחרי אחרי אחרי preposition unspecified unspecified unspecified unspecified unspecified  	O	null

0 זה זה זה pronoun masculine singular unspecified 3 unspecified  	O	null

0 אז אז אז conjunction unspecified unspecified unspecified unspecified unspecified  	O	null

0 מה מה מה interrogative unspecified unspecified unspecified unspecified unspecified  	O	null

0 אומר אמר אומר verb masculine singular unspecified any beinoni  	O	null

0 אחרי אחרי אחרי preposition unspecified unspecified unspecified unspecified unspecified  	O	null

0 זה זה זה pronoun masculine singular unspecified 3 unspecified  	O	null

0 דסייב דסייב דסייב verb masculine singular unspecified 2 future  	O	null

0 זיגמנטוביץ זיגמנטוביץ זיגמנטוביץ properName unspecified unspecified unspecified unspecified unspecified  	O	null

0 דמייננקו דמייננקו דמייננקו properName unspecified unspecified unspecified unspecified unspecified  	O	null

0 ניקו ניקה ניקו verb masculine-and-feminine plural unspecified 3 past  	O	null

0 קלאסן קלאסן קלאסן properName unspecified unspecified unspecified unspecified unspecified  	O	null

0 ו ו ומג conjunction unspecified unspecified unspecified unspecified unspecified 0 
0 מג מג ומג noun masculine singular absolute unspecified unspecified  	O	null

0 די די די adverb unspecified unspecified unspecified unspecified unspecified  	O	null

0 עבדל עבדל עבדל properName unspecified unspecified unspecified unspecified unspecified  	O	null

0 ראני ראני ראני preposition unspecified unspecified unspecified unspecified unspecified  	O	null

0 ושובייר ושובייר ושובייר properName unspecified unspecified unspecified unspecified unspecified  	O	null

0 ו ו וחוסם conjunction unspecified unspecified unspecified unspecified unspecified 0 
0 חוסם חסם וחוסם verb masculine singular unspecified any beinoni  	O	null

0 חסאן חסאן חסאן properName unspecified unspecified unspecified unspecified unspecified  	O	null

0 בטיסטה בטיסטה בטיסטה properName unspecified unspecified unspecified unspecified unspecified  	O	null

0 טרוליו טרוליו טרוליו adjective masculine plural absolute unspecified unspecified  	O	null

0 ו ו וסימון conjunction unspecified unspecified unspecified unspecified unspecified 0 
0 סימון סימון וסימון properName unspecified unspecified unspecified unspecified unspecified  	I_PERS	null

0 ו ו ופצל conjunction unspecified unspecified unspecified unspecified unspecified 0 
0 פצל פיצל ופצל verb masculine singular unspecified 3 past  	O	null

0 רודקס רודקס רודקס properName unspecified unspecified unspecified unspecified unspecified  	O	null

0 ומונזון ומונזון ומונזון properName unspecified unspecified unspecified unspecified unspecified  	O	null

0 ו ו ושיפו conjunction unspecified unspecified unspecified unspecified unspecified 0 
0 ש ש ושיפו relativizer/subordinatingConjunction unspecified unspecified unspecified unspecified unspecified 0 
0 יפו יפו ושיפו properName unspecified unspecified unspecified unspecified unspecified  	O	null

0 ל ל לינאקר preposition unspecified unspecified unspecified unspecified unspecified 0 
0 ה ה לינאקר definiteArticle unspecified unspecified unspecified unspecified unspecified 0 
0 הינאקר הינאקר לינאקר adjective masculine singular absolute unspecified unspecified  	O	null

0 ו ו וגרון conjunction unspecified unspecified unspecified unspecified unspecified 0 
0 גרון גרון וגרון noun masculine singular absolute unspecified unspecified  	O	null

0 מ מ מתיאוס preposition unspecified unspecified unspecified unspecified unspecified 0 
0 תיאוס תיאוס מתיאוס noun masculine singular absolute unspecified unspecified  	O	null

0 וואן וואן וואן properName unspecified unspecified unspecified unspecified unspecified  	O	null

0 ארלה ארלה ארלה properName unspecified unspecified unspecified unspecified unspecified  	O	null

0 אולי אולי אולי adverb unspecified unspecified unspecified unspecified unspecified  	O	null

0 תפסיק הפסיק תפסיק verb feminine singular unspecified 3 future  	O	null

0 ל ל לשיר preposition unspecified unspecified unspecified unspecified unspecified 0 
0 שיר שיר לשיר noun masculine singular absolute unspecified unspecified  	O	null

0 כבר כבר כבר adverb unspecified unspecified unspecified unspecified unspecified  	O	null

0 ו ו ותלך conjunction unspecified unspecified unspecified unspecified unspecified 0 
0 תלך הלך ותלך verb feminine singular unspecified 3 future  	O	null

0 הביתה הביתה הביתה adverb unspecified unspecified unspecified unspecified unspecified  	O	null

0 אהרל אהרל אהרל properName unspecified unspecified unspecified unspecified unspecified  	O	null

0 ה ה ה definiteArticle unspecified unspecified unspecified unspecified unspecified 0 	O	null

0 מ מ מתיאוס preposition unspecified unspecified unspecified unspecified unspecified 0 
0 תיאוס תיאוס מתיאוס noun masculine singular absolute unspecified unspecified  	O	null

0 ו ו ואן conjunction unspecified unspecified unspecified unspecified unspecified 0 
0 אן אן ואן properName unspecified unspecified unspecified unspecified unspecified  	I_PERS	null

0 ארלה ארלה ארלה properName unspecified unspecified unspecified unspecified unspecified  	O	null

0 מ מ מתיאוס preposition unspecified unspecified unspecified unspecified unspecified 0 
0 תיאוס תיאוס מתיאוס noun masculine singular absolute unspecified unspecified  	O	null

0 ו ו ואן conjunction unspecified unspecified unspecified unspecified unspecified 0 
0 אן אן ואן properName unspecified unspecified unspecified unspecified unspecified  	I_PERS	null

0 ארלה ארלה ארלה properName unspecified unspecified unspecified unspecified unspecified  	O	null

0 אם אם אם conjunction unspecified unspecified unspecified unspecified unspecified  	O	null

0 לא לא לא negation unspecified unspecified unspecified unspecified unspecified  	O	null

0 תפסיק הפסיק תפסיק verb feminine singular unspecified 3 future  	O	null

0 ל ל לשיר preposition unspecified unspecified unspecified unspecified unspecified 0 
0 שיר שיר לשיר noun masculine singular absolute unspecified unspecified  	O	null

0 מיד מייד מיד adverb unspecified unspecified unspecified unspecified unspecified  	O	null

0 יהיה הוא יהיה copula masculine singular unspecified 3 future  	O	null

0 כבר כבר כבר adverb unspecified unspecified unspecified unspecified unspecified  	O	null

0 מאוחר מאוחר מאוחר adverb unspecified unspecified unspecified unspecified unspecified  	O	null

0 ל ל לה preposition unspecified unspecified unspecified unspecified unspecified  
0 ה ה לה pronomial feminine singular unspecified 3 unspecified 0 	O	null

0 חרלה חרלה חרלה adjective masculine singular construct unspecified unspecified  	O	null

0 ו ו ואן conjunction unspecified unspecified unspecified unspecified unspecified 0 
0 אן אן ואן properName unspecified unspecified unspecified unspecified unspecified  	I_PERS	null

0 ארלה ארלה ארלה properName unspecified unspecified unspecified unspecified unspecified  	O	null

0 מ מ מתיאוס preposition unspecified unspecified unspecified unspecified unspecified 0 
0 תיאוס תיאוס מתיאוס noun masculine singular absolute unspecified unspecified  	O	null

0 ו ו ואן conjunction unspecified unspecified unspecified unspecified unspecified 0 
0 אן אן ואן properName unspecified unspecified unspecified unspecified unspecified  	I_PERS	null

0 ארלה ארלה ארלה properName unspecified unspecified unspecified unspecified unspecified  	O	null

0 רק רק רק conjunction unspecified unspecified unspecified unspecified unspecified  	O	null

0 עוד עוד עוד adverb unspecified unspecified unspecified unspecified unspecified  	O	null

0 אדגיש הדגיש אדגיש verb masculine-and-feminine singular unspecified 1 future  	O	null

0 את את את at-preposition unspecified unspecified unspecified unspecified unspecified  	O	null

0 גדעון גדעון גדעון properName unspecified unspecified unspecified unspecified unspecified  	I_PERS	null

0 טיש טיש טיש noun masculine singular absolute unspecified unspecified  	O	null

0 את את את at-preposition unspecified unspecified unspecified unspecified unspecified  	O	null

0 שפיגל שפיגל שפיגל properName unspecified unspecified unspecified unspecified unspecified  	I_PERS	null

0 שפיגלר שפיגלר שפיגלר properName unspecified unspecified unspecified unspecified unspecified  	O	null

0 שום שום שום quantifier unspecified unspecified construct unspecified unspecified  	O	null

0 ו ו וקיש conjunction unspecified unspecified unspecified unspecified unspecified 0 
0 קיש קיש וקיש noun masculine singular absolute unspecified unspecified  	O	null

0 את את את at-preposition unspecified unspecified unspecified unspecified unspecified  	O	null

0 גלזר גלזר גלזר properName unspecified unspecified unspecified unspecified unspecified  	I_PERS	null

0 סטלמך סטלמך סטלמך properName unspecified unspecified unspecified unspecified unspecified  	O	null

0 ו ו וסיני conjunction unspecified unspecified unspecified unspecified unspecified 0 
0 סיני סיני וסיני noun masculine singular absolute unspecified unspecified  	O	null

0 אברוצקי אברוצקי אברוצקי properName unspecified unspecified unspecified unspecified unspecified  	I_PERS	null

0 אלקולומברה אלקולומברה אלקולומברה adjective feminine singular absolute unspecified unspecified  	O	null

0 אמיגה אמיגה אמיגה properName unspecified unspecified unspecified unspecified unspecified  	O	null

0 הרשליקוביץ הרשליקוביץ הרשליקוביץ properName unspecified unspecified unspecified unspecified unspecified  	I_PERS	null

0 פרימו פרימו פרימו properName unspecified unspecified unspecified unspecified unspecified  	O	null

0 קסטרו קסטרו קסטרו properName unspecified unspecified unspecified unspecified unspecified  	I_ORG	null

0 בן בן בן properName unspecified unspecified unspecified unspecified unspecified  	I_PERS	null

0 ברוך ברוך ברוך properName unspecified unspecified unspecified unspecified unspecified  	I_PERS	null

0 וקיקו וקיקו וקיקו adverb unspecified unspecified unspecified unspecified unspecified  	O	null

0 רחמינוביץ רחמינוביץ רחמינוביץ properName unspecified unspecified unspecified unspecified unspecified  	O	null

0 ו ו וגוגו conjunction unspecified unspecified unspecified unspecified unspecified 0 
0 גוגו גוגו וגוגו noun feminine singular absolute unspecified unspecified  	O	null

0 מורדכוביץ מורדכוביץ מורדכוביץ properName unspecified unspecified unspecified unspecified unspecified  	O	null

0 נו נו נו interjection unspecified unspecified unspecified unspecified unspecified  	O	null

0 די די די adverb unspecified unspecified unspecified unspecified unspecified  	O	null

0 כבר כבר כבר adverb unspecified unspecified unspecified unspecified unspecified  	O	null

0 ו ו ורוזנבוים conjunction unspecified unspecified unspecified unspecified unspecified 0 
0 רוזנבוים רוזנבוים ורוזנבוים noun feminine singular absolute unspecified unspecified  	O	null

0 נו נו נו interjection unspecified unspecified unspecified unspecified unspecified  	O	null

0 די די די adverb unspecified unspecified unspecified unspecified unspecified  	O	null

0 כבר כבר כבר adverb unspecified unspecified unspecified unspecified unspecified  	O	null

0 ופייגנבוים ופייגנבוים ופייגנבוים properName unspecified unspecified unspecified unspecified unspecified  	O	null

0 ו ו וקרויף conjunction unspecified unspecified unspecified unspecified unspecified 0 
0 קרויף קרויף וקרויף noun masculine singular absolute unspecified unspecified  	O	null

0 גארינץ גארינץ גארינצ properName unspecified unspecified unspecified unspecified unspecified  	O	null

0 ה ה ה definiteArticle unspecified unspecified unspecified unspecified unspecified 0 	O	null

0 ופל ופל ופלה noun masculine singular absolute unspecified unspecified  
0 ה ה ופלה possessive feminine singular unspecified 3 unspecified 0 	O	null

0 ו ו ואסיים conjunction unspecified unspecified unspecified unspecified unspecified 0 
0 אסיים סיים ואסיים verb masculine-and-feminine singular unspecified 1 future  	O	null

0 ב ב בחודורוב preposition unspecified unspecified unspecified unspecified unspecified 0 
0 חודורוב חודורוב בחודורוב noun masculine singular absolute unspecified unspecified  	O	null

0 כן כן כן conjunction unspecified unspecified unspecified unspecified unspecified  	O	null

0 אסיים סיים אסיים verb masculine-and-feminine singular unspecified 1 future  	O	null

0 ב ב בחודורוב preposition unspecified unspecified unspecified unspecified unspecified 0 
0 חודורוב חודורוב בחודורוב noun masculine singular absolute unspecified unspecified  	O	null

0 כן כן כן conjunction unspecified unspecified unspecified unspecified unspecified  	O	null

0 אסיים סיים אסיים verb masculine-and-feminine singular unspecified 1 future  	O	null

0 ב ב בחודורוב preposition unspecified unspecified unspecified unspecified unspecified 0 
0 חודורוב חודורוב בחודורוב noun masculine singular absolute unspecified unspecified  	O	null

