0 אצה אצה אצה noun feminine singular absolute unspecified unspecified  	O	null

0 רצה רצה רצה verb masculine singular unspecified 3 past  	O	null

0 מכונית מכונית מכונית noun feminine singular construct unspecified unspecified  	O	null

0 שחורה שחור שחורה adjective feminine singular absolute unspecified unspecified  	I_LOC	null

0 מובילה הוביל מובילה verb feminine singular unspecified any beinoni  	O	null

0 ב ב בראש preposition unspecified unspecified unspecified unspecified unspecified 0 
0 ראש ראש בראש noun masculine singular absolute unspecified unspecified  	O	null

0 ה ה השיירה definiteArticle unspecified unspecified unspecified unspecified unspecified 0 
0 השיירה שיירה השיירה noun feminine singular absolute unspecified unspecified  	O	null

0 אל אל אל preposition unspecified unspecified unspecified unspecified unspecified  	O	null

0 דרך דרך דרכו noun feminine singular absolute unspecified unspecified  
0 ו ו דרכו possessive masculine singular unspecified 3 unspecified 0 	O	null

0 ה ה האחרונה definiteArticle unspecified unspecified unspecified unspecified unspecified 0 
0 האחרונה אחרון האחרונה adjective feminine singular absolute unspecified unspecified  	O	null

0 הוא הוא הוא pronoun masculine singular unspecified 3 unspecified  	O	null

0 בא בא בא verb masculine singular unspecified 3 past  	O	null

0 ליאו לאו ליאו properName unspecified unspecified unspecified unspecified unspecified  	O	null

0 לוי לוי לוי properName unspecified unspecified unspecified unspecified unspecified  	I_PERS	null

0 ב ב בשיבה preposition unspecified unspecified unspecified unspecified unspecified 0 
0 ה ה בשיבה definiteArticle unspecified unspecified unspecified unspecified unspecified 0 
0 השיבה שיבה בשיבה noun feminine singular absolute unspecified unspecified  	O	null

0 טובה טובה טובה noun feminine singular absolute unspecified unspecified  	O	null

