0 תל תל תל properName unspecified unspecified unspecified unspecified unspecified  	O	null

0 אביב אביב אביב properName unspecified unspecified unspecified unspecified unspecified  	I_PERS	null

0 חמה חם חמה adjective feminine singular absolute unspecified unspecified  	O	null

0 תל תל תל properName unspecified unspecified unspecified unspecified unspecified  	O	null

0 אביב אביב אביב properName unspecified unspecified unspecified unspecified unspecified  	I_PERS	null

0 צוחקת צחק צוחקת verb feminine singular unspecified any beinoni  	O	null

0 אנחנו הוא אנחנו pronoun masculine-and-feminine plural unspecified 1 unspecified  	O	null

0 עוד עוד עוד adverb unspecified unspecified unspecified unspecified unspecified  	O	null

0 קטנים קטן קטנים adjective masculine plural absolute unspecified unspecified  	O	null

0 ו ו ויש conjunction unspecified unspecified unspecified unspecified unspecified 0 
0 יש יש ויש existential unspecified unspecified unspecified unspecified unspecified  	O	null

0 מעט מעט מעט adverb unspecified unspecified unspecified unspecified unspecified  	O	null

0 מאוד מאוד מאוד adverb unspecified unspecified unspecified unspecified unspecified  	O	null

0 עיר עיר עיר noun feminine singular construct unspecified unspecified  	O	null

0 של של של shel-preposition unspecified unspecified unspecified unspecified unspecified  	O	null

0 אהבה אהבה אהבה noun feminine singular absolute unspecified unspecified  	O	null

0 עיר עיר עיר noun feminine singular construct unspecified unspecified  	O	null

0 ש ש שלא relativizer/subordinatingConjunction unspecified unspecified unspecified unspecified unspecified 0 
0 לא לא שלא negation unspecified unspecified unspecified unspecified unspecified  	O	null

0 חונקת חנק חונקת verb feminine singular unspecified any beinoni  	O	null

0 שמש שמש שמש properName unspecified unspecified unspecified unspecified unspecified  	I_PERS	null

0 ב ב בגני preposition unspecified unspecified unspecified unspecified unspecified 0 
0 גני גן בגני noun masculine plural construct unspecified unspecified  	O	null

0 היה הוא היה copula masculine singular unspecified 3 past  	O	null

0 היו הוא היו copula masculine plural unspecified 2 imperative  	O	null

0 לילות לילה לילות noun masculine plural absolute unspecified unspecified  	O	null

