0 סלעים סלע סלעים noun masculine plural absolute unspecified unspecified  	O	null

0 ו ו וים conjunction unspecified unspecified unspecified unspecified unspecified 0 
0 ים ים וים noun masculine singular absolute unspecified unspecified  	O	null

0 שחפים שחף שחפים noun masculine plural absolute unspecified unspecified  	O	null

0 ישבו ישב ישבו verb masculine-and-feminine plural unspecified 3 past  	O	null

0 ל ל לנוח preposition unspecified unspecified unspecified unspecified unspecified 0 
0 נוח נוח לנוח noun masculine singular absolute unspecified unspecified  	O	null

0 כ כ כחום preposition unspecified unspecified unspecified unspecified unspecified 0 
0 חום חום כחום noun masculine singular absolute unspecified unspecified  	O	null

0 היום היום היום adverb unspecified unspecified unspecified unspecified unspecified  	O	null

0 ה ה הים definiteArticle unspecified unspecified unspecified unspecified unspecified 0 
0 הים ים הים noun masculine singular absolute unspecified unspecified  	O	null

0 כחול כחול כחול adjective masculine singular absolute unspecified unspecified  	O	null

0 לאט לאט לאט adverb unspecified unspecified unspecified unspecified unspecified  	O	null

0 ישוב יישוב ישוב noun masculine singular absolute unspecified unspecified  	O	null

0 ה ה הרוח definiteArticle unspecified unspecified unspecified unspecified unspecified 0 
0 הרוח רוח הרוח noun feminine singular absolute unspecified unspecified  	O	null

0 מרחב מרחב מרחב noun masculine singular construct unspecified unspecified  	O	null

0 ו ו ורום conjunction unspecified unspecified unspecified unspecified unspecified 0 
0 רום רום ורום properName masculine singular unspecified unspecified unspecified  	I_PERS	null

0 שלווה שלווה שלווה noun feminine singular absolute unspecified unspecified  	O	null

0 כ כ כזאת preposition unspecified unspecified unspecified unspecified unspecified 0 
0 זאת זאת כזאת pronoun feminine singular unspecified 3 unspecified  	O	null

0 על על על preposition unspecified unspecified unspecified unspecified unspecified  	O	null

0 סלע סלע סלע properName unspecified unspecified unspecified unspecified unspecified  	I_PERS	null

0 ו ו ועל conjunction unspecified unspecified unspecified unspecified unspecified 0 
0 על על ועל preposition unspecified unspecified unspecified unspecified unspecified  	O	null

0 מים מים מים noun masculine plural absolute unspecified unspecified  	O	null

0 ב ב בחודש preposition unspecified unspecified unspecified unspecified unspecified 0 
0 חודש חודש בחודש noun masculine singular absolute unspecified unspecified  	O	null

0 אב אב אב noun masculine singular absolute unspecified unspecified  	I_DATE	null

0 הנה הנה הנה conjunction unspecified unspecified unspecified unspecified unspecified  	O	null

0 אחד איחד אחד verb masculine singular unspecified 3 past  	O	null

0 המריא המריא המריא verb masculine singular unspecified 3 past  	O	null

0 פרש פרש פרש verb masculine singular unspecified 3 past  	O	null

0 כנפיים כנפיים כנפיים properName unspecified unspecified unspecified unspecified unspecified  	I_ORG	null

0 ו ו ועף conjunction unspecified unspecified unspecified unspecified unspecified 0 
0 עף עף ועף verb masculine singular unspecified 3 past  	O	null

