0 באה בא באה verb feminine singular unspecified 3 past  	O	null

0 מנוחה מנוחה מנוחה noun feminine singular absolute unspecified unspecified  	O	null

0 ל ל ליגע preposition unspecified unspecified unspecified unspecified unspecified 0 
0 יגע יגע ליגע noun masculine singular absolute unspecified unspecified  	O	null

0 ו ו ומרגוע conjunction unspecified unspecified unspecified unspecified unspecified 0 
0 מרגוע מרגוע ומרגוע noun masculine singular absolute unspecified unspecified  	O	null

0 ל ל לעמל preposition unspecified unspecified unspecified unspecified unspecified 0 
0 עמל עמל לעמל noun masculine singular absolute unspecified unspecified  	O	null

0 לילה לילה לילה noun masculine singular absolute unspecified unspecified  	O	null

0 חיוור חיוור חיוור adjective masculine singular absolute unspecified unspecified  	O	null

0 משתרע השתרע משתרע verb masculine singular unspecified any beinoni  	O	null

0 על על על preposition unspecified unspecified unspecified unspecified unspecified  	O	null

0 שדות שדה שדות noun masculine plural construct unspecified unspecified  	O	null

0 עמק עמק עמק noun masculine singular construct unspecified unspecified  	O	null

0 יזרעאל יזרעאל יזרעאל properName unspecified unspecified unspecified unspecified unspecified  	I_PERS	null

0 טל טל טל properName unspecified unspecified unspecified unspecified unspecified  	I_PERS	null

0 מלמטה מלמטה מלמטה adverb unspecified unspecified unspecified unspecified unspecified  	O	null

0 ו ו ולבנה conjunction unspecified unspecified unspecified unspecified unspecified 0 
0 ל ל ולבנה preposition unspecified unspecified unspecified unspecified unspecified 0 
0 בן בן ולבנה noun masculine singular absolute unspecified unspecified  
0 ה ה ולבנה possessive feminine singular unspecified 3 unspecified 0 	O	null

0 מעל מעל מעל preposition unspecified unspecified unspecified unspecified unspecified  	O	null

0 מ מ מבית preposition unspecified unspecified unspecified unspecified unspecified 0 
0 בית בית מבית noun masculine singular construct unspecified unspecified  	O	null

0 אלפא אלפא אלפא properName unspecified unspecified unspecified unspecified unspecified  	O	null

0 עד עד עד noun masculine singular absolute unspecified unspecified  	O	null

0 נהלל נהלל נהלל properName masculine singular unspecified unspecified unspecified  	O	null

0 אופל אופל אופל noun masculine singular absolute unspecified unspecified  	O	null

0 ב ב בהר preposition unspecified unspecified unspecified unspecified unspecified 0 
0 הר הר בהר noun masculine singular construct unspecified unspecified  	O	null

0 ה ה הגלבוע definiteArticle unspecified unspecified unspecified unspecified unspecified 0 
0 הגלבוע גלבוע הגלבוע properName unspecified unspecified unspecified unspecified unspecified  	I_PERS	null

0 סוס סוס סוס noun masculine singular absolute unspecified unspecified  	O	null

0 דוהר דהר דוהר verb masculine singular unspecified any beinoni  	O	null

0 מ מ מצל preposition unspecified unspecified unspecified unspecified unspecified 0 
0 צל צל מצל noun masculine singular absolute unspecified unspecified  	O	null

0 אל אל אל preposition unspecified unspecified unspecified unspecified unspecified  	O	null

0 צל צל צל noun masculine singular absolute unspecified unspecified  	O	null

0 קול קול קול noun masculine singular construct unspecified unspecified  	O	null

0 זעקה זעקה זעקה noun feminine singular absolute unspecified unspecified  	O	null

0 עף עף עף verb masculine singular unspecified 3 past  	O	null

0 גבוה גבוה גבוה adjective masculine singular absolute unspecified unspecified  	O	null

0 על על על preposition unspecified unspecified unspecified unspecified unspecified  	O	null

0 שדות שדה שדות noun masculine plural construct unspecified unspecified  	O	null

0 עמק עמק עמק noun masculine singular construct unspecified unspecified  	O	null

0 יזרעאל יזרעאל יזרעאל properName unspecified unspecified unspecified unspecified unspecified  	I_PERS	null

0 מי מי מי interrogative unspecified unspecified unspecified unspecified unspecified  	O	null

0 ירה ירה ירה verb masculine singular unspecified 3 past  	O	null

0 ו ו ומי conjunction unspecified unspecified unspecified unspecified unspecified 0 
0 מי מי ומי interrogative unspecified unspecified unspecified unspecified unspecified  	O	null

0 זה זה זה pronoun masculine singular unspecified 3 unspecified  	O	null

0 שם שם שם adverb unspecified unspecified unspecified unspecified unspecified  	O	null

0 נפל נפל נפל verb masculine singular unspecified 3 past  	O	null

0 בין בין בין preposition unspecified unspecified unspecified unspecified unspecified  	O	null

0 בית בית בית noun masculine singular construct unspecified unspecified  	O	null

0 אלפא אלפא אלפא properName unspecified unspecified unspecified unspecified unspecified  	O	null

0 ו ו ונהלל conjunction unspecified unspecified unspecified unspecified unspecified 0 
0 נהלל נהלל ונהלל properName masculine singular unspecified unspecified unspecified  	O	null

0 ים ים ים noun masculine singular absolute unspecified unspecified  	O	null

0 ה ה הדגן definiteArticle unspecified unspecified unspecified unspecified unspecified 0 
0 הדגן דגן הדגן noun masculine singular absolute unspecified unspecified  	O	null

0 מתנועע התנועע מתנועע verb masculine singular unspecified any beinoni  	O	null

0 שיר שיר שיר noun masculine singular absolute unspecified unspecified  	O	null

0 העדר העדר העדר noun masculine singular construct unspecified unspecified  	O	null

0 מצלצל צלצל מצלצל verb masculine singular unspecified any beinoni  	O	null

0 זוהי זהו זוהי pronoun feminine singular unspecified 3 unspecified  	O	null

0 ארצי ארצי ארצי properName unspecified unspecified unspecified unspecified unspecified  	I_PERS	null

0 ו ו ושדותיה conjunction unspecified unspecified unspecified unspecified unspecified 0 
0 שדות שד ושדותיה noun feminine plural absolute unspecified unspecified  
0 ה ה ושדותיה possessive feminine singular unspecified 3 unspecified 0 	O	null

0 זהו זהו זהו pronoun masculine singular unspecified 3 unspecified  	O	null

0 עמק עמק עמק noun masculine singular construct unspecified unspecified  	O	null

0 יזרעאל יזרעאל יזרעאל properName unspecified unspecified unspecified unspecified unspecified  	I_PERS	null

0 תבורך בורך תבורך verb feminine singular unspecified 3 future  	O	null

0 ארצי ארצי ארצי properName unspecified unspecified unspecified unspecified unspecified  	I_PERS	null

0 ו ו ותהולל conjunction unspecified unspecified unspecified unspecified unspecified 0 
0 תהולל הולל ותהולל verb masculine singular unspecified 2 future  	O	null

0 מ מ מבית preposition unspecified unspecified unspecified unspecified unspecified 0 
0 בית בית מבית noun masculine singular construct unspecified unspecified  	O	null

0 אלפא אלפא אלפא properName unspecified unspecified unspecified unspecified unspecified  	O	null

0 עד עד עד noun masculine singular absolute unspecified unspecified  	O	null

0 נהלל נהלל נהלל properName masculine singular unspecified unspecified unspecified  	O	null

