0 ב ב בשדות preposition unspecified unspecified unspecified unspecified unspecified 0 
0 שדות שדה בשדות noun masculine plural absolute unspecified unspecified  	O	null

0 גווע גווע גווע verb masculine singular unspecified 3 past  	O	null

0 ה ה הקיץ definiteArticle unspecified unspecified unspecified unspecified unspecified 0 
0 הקיץ קיץ הקיץ noun masculine singular absolute unspecified unspecified  	I_DATE	null

0 ו ו והערב conjunction unspecified unspecified unspecified unspecified unspecified 0 
0 הערב הערב והערב adverb unspecified unspecified unspecified unspecified unspecified  	O	null

0 מתגנב התגנב מתגנב verb masculine singular unspecified any beinoni  	O	null

0 רוח רוח רוח noun feminine singular construct unspecified unspecified  	O	null

0 סתיו סתיו סתיו noun masculine singular absolute unspecified unspecified  	I_DATE	null

0 תפיל הפיל תפיל verb feminine singular unspecified 3 future  	O	null

0 שלכת שלכת שלכת noun feminine singular absolute unspecified unspecified  	O	null

0 שוב שוב שוב adverb unspecified unspecified unspecified unspecified unspecified  	O	null

0 ה ה החורף definiteArticle unspecified unspecified unspecified unspecified unspecified 0 
0 החורף חורף החורף noun masculine singular absolute unspecified unspecified  	I_DATE	null

0 מתקרב התקרב מתקרב verb masculine singular unspecified any beinoni  	O	null

0 ו ו ופתאום conjunction unspecified unspecified unspecified unspecified unspecified 0 
0 פתאום פתאום ופתאום adverb unspecified unspecified unspecified unspecified unspecified  	O	null

0 ברק ברק ברק properName unspecified unspecified unspecified unspecified unspecified  	I_PERS	null

0 מבריק מבריק מבריק adjective masculine singular absolute unspecified unspecified  	O	null

0 מ מ מפלח preposition unspecified unspecified unspecified unspecified unspecified 0 
0 פלח פלח מפלח noun masculine singular absolute unspecified unspecified  	O	null

0 לילה לילה לילה noun masculine singular absolute unspecified unspecified  	O	null

0 קר קר קר adjective masculine singular absolute unspecified unspecified  	O	null

0 ו ו ועיניך conjunction unspecified unspecified unspecified unspecified unspecified 0 
0 עין עין ועיניך noun feminine plural absolute unspecified unspecified  
0 ך ך ועיניך possessive feminine singular unspecified 2 unspecified 0 	O	null

0 אז אז אז conjunction unspecified unspecified unspecified unspecified unspecified  	O	null

0 תשאלנה שאל תשאלנה verb feminine plural unspecified 2 future  	O	null

0 מה מה מה interrogative unspecified unspecified unspecified unspecified unspecified  	O	null

0 יהיה הוא יהיה copula masculine singular unspecified 3 future  	O	null

0 מחר מחר מחר adverb unspecified unspecified unspecified unspecified unspecified  	O	null

0 ה ה החיטה definiteArticle unspecified unspecified unspecified unspecified unspecified 0 
0 החיטה חיטה החיטה noun feminine singular absolute unspecified unspecified  	O	null

0 עולה עלה עולה verb masculine singular unspecified any beinoni  	O	null

0 ב ב ביוקר preposition unspecified unspecified unspecified unspecified unspecified 0 
0 ה ה ביוקר definiteArticle unspecified unspecified unspecified unspecified unspecified 0 
0 היוקר יוקר ביוקר noun masculine singular absolute unspecified unspecified  	O	null

0 ה ה הלירה definiteArticle unspecified unspecified unspecified unspecified unspecified 0 
0 הלירה לירה הלירה noun feminine singular absolute unspecified unspecified  	O	null

0 הצטמקה הצטמק הצטמקה verb feminine singular unspecified 3 past  	O	null

0 ה ה הזריחה definiteArticle unspecified unspecified unspecified unspecified unspecified 0 
0 הזריחה זריחה הזריחה noun feminine singular absolute unspecified unspecified  	O	null

0 יפה יפה יפה adverb unspecified unspecified unspecified unspecified unspecified  	O	null

0 ה ה הבוקר definiteArticle unspecified unspecified unspecified unspecified unspecified 0 
0 הבוקר בוקר הבוקר noun masculine singular absolute unspecified unspecified  	O	null

0 יהיה הוא יהיה copula masculine singular unspecified 3 future  	O	null

0 חם חם חם adjective masculine singular absolute unspecified unspecified  	O	null

0 ב ב בערבה preposition unspecified unspecified unspecified unspecified unspecified 0 
0 ערב ערב בערבה noun masculine singular absolute unspecified unspecified  
0 ה ה בערבה possessive feminine singular unspecified 3 unspecified 0 	I_LOC	null

0 ו ו וראשך conjunction unspecified unspecified unspecified unspecified unspecified 0 
0 ראש ראש וראשך noun masculine singular absolute unspecified unspecified  
0 ך ך וראשך possessive feminine singular unspecified 2 unspecified 0 	O	null

0 ליד ליד ליד preposition unspecified unspecified unspecified unspecified unspecified  	O	null

0 ראשי ראש ראשי noun masculine plural construct unspecified unspecified  	O	null

0 שותק שתק שותק verb masculine singular unspecified any beinoni  	O	null

0 אל אל אל preposition unspecified unspecified unspecified unspecified unspecified  	O	null

0 תוך תוך תוך noun masculine singular construct unspecified unspecified  	O	null

0 ה ה הכר definiteArticle unspecified unspecified unspecified unspecified unspecified 0 
0 הכר כר הכר noun masculine singular absolute unspecified unspecified  	O	null

0 ו ו ואני conjunction unspecified unspecified unspecified unspecified unspecified 0 
0 אני הוא ואני pronoun masculine-and-feminine singular unspecified 1 unspecified  	O	null

0 אני הוא אני pronoun masculine-and-feminine singular unspecified 1 unspecified  	O	null

0 לא לא לא negation unspecified unspecified unspecified unspecified unspecified  	O	null

0 יודע ידע יודע verb masculine singular unspecified any beinoni  	O	null

0 מה מה מה interrogative unspecified unspecified unspecified unspecified unspecified  	O	null

0 יהיה הוא יהיה copula masculine singular unspecified 3 future  	O	null

0 מחר מחר מחר adverb unspecified unspecified unspecified unspecified unspecified  	O	null

