0 שבחי שבח שבחי noun masculine plural construct unspecified unspecified  	O	null

0 ירושלים ירושלים ירושלים properName unspecified unspecified unspecified unspecified unspecified  	I_LOC	null

0 את את את at-preposition unspecified unspecified unspecified unspecified unspecified  	O	null

0 אדוני אדון אדוני noun masculine plural construct unspecified unspecified  	O	null

0 הללי הילל הללי verb feminine singular unspecified 2 imperative  	O	null

0 אלוהי אלוהים אלוהיך noun masculine singular absolute unspecified unspecified  
0 ך ך אלוהיך possessive feminine singular unspecified 2 unspecified 0 	O	null

0 ציון ציון ציון properName unspecified unspecified unspecified unspecified unspecified  	I_PERS	null

0 כי כי כי conjunction unspecified unspecified unspecified unspecified unspecified  	O	null

0 חיזק חיזק חיזק verb masculine singular unspecified 3 past  	O	null

0 בריחי בריח בריחי noun masculine plural construct unspecified unspecified  	O	null

0 שעריי שער שערייך noun masculine plural absolute unspecified unspecified  
0 ך ך שערייך possessive feminine singular unspecified 2 unspecified 0 	O	null

0 ברך ברך ברך noun feminine singular construct unspecified unspecified  	O	null

0 בניי בן בנייך noun masculine plural absolute unspecified unspecified  
0 ך ך בנייך possessive feminine singular unspecified 2 unspecified 0 	O	null

0 בקרב בקרב בקרבך preposition unspecified unspecified unspecified unspecified unspecified  
0 ך ך בקרבך pronomial masculine singular unspecified 2 unspecified 0 	O	null

0 הללי הילל הללי verb feminine singular unspecified 2 imperative  	O	null

0 הללי הילל הללי verb feminine singular unspecified 2 imperative  	O	null

0 אלוהייך אלוהייך אלוהייך verb masculine singular unspecified 2 imperative  	O	null

0 ציון ציון ציון properName unspecified unspecified unspecified unspecified unspecified  	I_PERS	null

