0 להקיץ הקיץ להקיץ verb unspecified unspecified unspecified unspecified infinitive  	O	null

0 אל אל אל preposition unspecified unspecified unspecified unspecified unspecified  	O	null

0 לילה לילה לילה noun masculine singular absolute unspecified unspecified  	O	null

0 ער ער ער adjective masculine singular absolute unspecified unspecified  	O	null

0 ו ו ודרוך conjunction unspecified unspecified unspecified unspecified unspecified 0 
0 דרוך דרוך ודרוך adjective masculine singular absolute unspecified unspecified  	O	null

0 על על על preposition unspecified unspecified unspecified unspecified unspecified  	O	null

0 מפתן מפתן מפתן noun masculine singular construct unspecified unspecified  	O	null

0 ה ה השחר definiteArticle unspecified unspecified unspecified unspecified unspecified 0 
0 השחר שחר השחר noun masculine singular absolute unspecified unspecified  	O	null

0 חצות חצות חצות noun feminine singular absolute unspecified unspecified  	I_TIME	null

0 מכה מכה מכה noun feminine singular absolute unspecified unspecified  	O	null

0 ב ב בסנורים preposition unspecified unspecified unspecified unspecified unspecified 0 
0 ה ה בסנורים definiteArticle unspecified unspecified unspecified unspecified unspecified 0 
0 הסנורים הסנורים בסנורים adjective masculine plural absolute unspecified unspecified  	O	null

0 או או או conjunction unspecified unspecified unspecified unspecified unspecified  	O	null

0 שמא שמא שמא adverb unspecified unspecified unspecified unspecified unspecified  	O	null

0 שכור שכור שכור adjective masculine singular absolute unspecified unspecified  	I_ORG	null

0 משמש שימש משמש verb masculine singular unspecified any beinoni  	O	null

0 אתמול אתמול אתמול adverb unspecified unspecified unspecified unspecified unspecified  	O	null

0 שתש שתש שתש adverb unspecified unspecified unspecified unspecified unspecified  	O	null

0 כחו כחו כחו noun masculine singular absolute unspecified unspecified  	O	null

0 מערב מערב מערבו noun masculine singular absolute unspecified unspecified  
0 ו ו מערבו possessive masculine singular unspecified 3 unspecified 0 	O	null

0 ה ה הסואן definiteArticle unspecified unspecified unspecified unspecified unspecified 0 
0 הסואן סואן הסואן adjective masculine singular absolute unspecified unspecified  	O	null

0 בין בין ביניהם preposition unspecified unspecified unspecified unspecified unspecified  
0 הם הם ביניהם pronomial masculine plural unspecified 3 unspecified 0 	O	null

0 חומק חמק חומק verb masculine singular unspecified any beinoni  	O	null

0 ליל ליל לילו noun masculine singular absolute unspecified unspecified  
0 ו ו לילו possessive masculine singular unspecified 3 unspecified 0 	O	null

0 של של של shel-preposition unspecified unspecified unspecified unspecified unspecified  	O	null

0 אלול אלול אלול properName masculine singular unspecified unspecified unspecified  	I_PERS	null

0 לקראת לקראת לקראת preposition unspecified unspecified unspecified unspecified unspecified  	O	null

0 תשרי תשרי תשרי properName masculine singular unspecified unspecified unspecified  	I_DATE	null

