0 בין בין בין preposition unspecified unspecified unspecified unspecified unspecified  	O	null

0 נהר נהר נהר noun masculine singular construct unspecified unspecified  	O	null

0 פרת פרה פרת noun feminine singular construct unspecified unspecified  	O	null

0 ו ו ונהר conjunction unspecified unspecified unspecified unspecified unspecified 0 
0 נהר נהר ונהר noun masculine singular absolute unspecified unspecified  	O	null

0 חידקל חידקל חידקל properName unspecified unspecified unspecified unspecified unspecified  	O	null

0 על על על preposition unspecified unspecified unspecified unspecified unspecified  	O	null

0 ה ה ההר definiteArticle unspecified unspecified unspecified unspecified unspecified 0 
0 ההר הר ההר noun masculine singular absolute unspecified unspecified  	O	null

0 מיתמר מיתמר מיתמר noun masculine singular absolute unspecified unspecified  	O	null

0 דקל דקל דקל properName unspecified unspecified unspecified unspecified unspecified  	I_PERS	null

0 ו ו ובדקל conjunction unspecified unspecified unspecified unspecified unspecified 0 
0 ב ב ובדקל preposition unspecified unspecified unspecified unspecified unspecified 0 
0 דקל דקל ובדקל properName masculine singular unspecified unspecified unspecified  	I_PERS	null

0 בין בין בין preposition unspecified unspecified unspecified unspecified unspecified  	O	null

0 עפאיו עפאיו עפאיו properName unspecified unspecified unspecified unspecified unspecified  	O	null

0 תשכן שיכן תשכן verb feminine singular unspecified 3 future  	O	null

0 ל ל לה preposition unspecified unspecified unspecified unspecified unspecified  
0 ה ה לה pronomial feminine singular unspecified 3 unspecified 0 	O	null

0 דוכיפת דוכיפת דוכיפת noun feminine singular absolute unspecified unspecified  	O	null

0 זהב זהב זהב noun masculine singular absolute unspecified unspecified  	O	null

