0 על על על preposition unspecified unspecified unspecified unspecified unspecified  	O	null

0 גג גג גג noun masculine singular absolute unspecified unspecified  	O	null

0 דוד דוד דוד properName unspecified unspecified unspecified unspecified unspecified  	I_PERS	null

0 שמש שמש שמש properName unspecified unspecified unspecified unspecified unspecified  	I_PERS	null

0 ו ו ואנטנה conjunction unspecified unspecified unspecified unspecified unspecified 0 
0 אנטנה אנטנה ואנטנה noun feminine singular absolute unspecified unspecified  	O	null

0 גם גם גם conjunction unspecified unspecified unspecified unspecified unspecified  	O	null

0 רוקדים רקד רוקדים verb masculine plural unspecified any beinoni  	O	null

0 בולרו בולרו בולרו verb masculine-and-feminine plural unspecified 3 past  	O	null

0 מצפצפים צפצף מצפצפים verb masculine plural unspecified any beinoni  	O	null

0 על על על preposition unspecified unspecified unspecified unspecified unspecified  	O	null

0 ה ה העולם definiteArticle unspecified unspecified unspecified unspecified unspecified 0 
0 העולם עולם העולם noun masculine singular absolute unspecified unspecified  	O	null

0 ו ו ולא conjunction unspecified unspecified unspecified unspecified unspecified 0 
0 לא לא ולא negation unspecified unspecified unspecified unspecified unspecified  	O	null

0 איכפת אכפת איכפת adverb unspecified unspecified unspecified unspecified unspecified  	O	null

0 ל ל להם preposition unspecified unspecified unspecified unspecified unspecified  
0 הם הם להם pronomial masculine plural unspecified 3 unspecified 0 	O	null

0 מ מ מכלום preposition unspecified unspecified unspecified unspecified unspecified 0 
0 כ כ מכלום adverb unspecified unspecified unspecified unspecified unspecified 0 
0 לום לום מכלום noun masculine singular absolute unspecified unspecified  	O	null

0 ו ו ומכולם conjunction unspecified unspecified unspecified unspecified unspecified 0 
0 מ מ ומכולם preposition unspecified unspecified unspecified unspecified unspecified 0 
0 כולם כולם ומכולם pronoun masculine plural unspecified 3 unspecified  	O	null

0 ו ו ורק conjunction unspecified unspecified unspecified unspecified unspecified 0 
0 רק רק ורק conjunction unspecified unspecified unspecified unspecified unspecified  	O	null

0 הסנטימנט הסנטימנט הסנטימנט noun feminine singular construct unspecified unspecified  	O	null

0 הזה הזה הזה verb masculine singular unspecified 3 past  	O	null

0 ש ש שבליבם relativizer/subordinatingConjunction unspecified unspecified unspecified unspecified unspecified 0 
0 ב ב שבליבם preposition unspecified unspecified unspecified unspecified unspecified 0 
0 ליב לב שבליבם noun masculine singular absolute unspecified unspecified  
0 ם ם שבליבם possessive masculine plural unspecified 3 unspecified 0 	O	null

0 ש ש שמחמם relativizer/subordinatingConjunction unspecified unspecified unspecified unspecified unspecified 0 
0 מחמם חימם שמחמם verb masculine singular unspecified any beinoni  	O	null

0 אנטנה אנטנה אנטנה noun feminine singular absolute unspecified unspecified  	O	null

0 ו ו ודוד conjunction unspecified unspecified unspecified unspecified unspecified 0 
0 דוד דוד ודוד properName unspecified unspecified unspecified unspecified unspecified  	I_PERS	null

0 גם גם גם conjunction unspecified unspecified unspecified unspecified unspecified  	O	null

0 כמעט כמעט כמעט adverb unspecified unspecified unspecified unspecified unspecified  	O	null

0 עשרים ORD-CARD20 עשרים numeral masculine-and-feminine plural construct unspecified unspecified  	O	null

0 ו ו ושש conjunction unspecified unspecified unspecified unspecified unspecified 0 
0 שש שש ושש noun masculine singular absolute unspecified unspecified  	O	null

0 ב ב בצלזיוס preposition unspecified unspecified unspecified unspecified unspecified 0 
0 צלזיוס צלזיוס בצלזיוס noun masculine singular absolute unspecified unspecified  	O	null

0 אבוד אבוד אבוד adjective masculine singular absolute unspecified unspecified  	O	null

0 גונח גנח גונח verb masculine singular unspecified any beinoni  	O	null

0 דוד דוד דוד properName unspecified unspecified unspecified unspecified unspecified  	I_PERS	null

0 מ מ מהתרגשות preposition unspecified unspecified unspecified unspecified unspecified 0 
0 התרגשות התרגשות מהתרגשות noun feminine singular absolute unspecified unspecified  	O	null

0 ב ב בלב preposition unspecified unspecified unspecified unspecified unspecified 0 
0 לב לב בלב noun masculine singular absolute unspecified unspecified  	O	null

0 אנטנה אנטנה אנטנה noun feminine singular absolute unspecified unspecified  	O	null

0 מ מ מזמזם preposition unspecified unspecified unspecified unspecified unspecified 0 
0 זמזם זמזם מזמזם noun masculine singular absolute unspecified unspecified  	O	null

0 איזה איזה איזה quantifier unspecified unspecified construct unspecified unspecified  	O	null

0 אלחוט אלחוט אלחוט noun masculine singular absolute unspecified unspecified  	O	null

0 של של של shel-preposition unspecified unspecified unspecified unspecified unspecified  	O	null

0 שטות שטות שטות noun feminine singular absolute unspecified unspecified  	O	null

0 אני הוא אני pronoun masculine-and-feminine singular unspecified 1 unspecified  	O	null

0 פשוט פשוט פשוט adverb unspecified unspecified unspecified unspecified unspecified  	O	null

0 מבולבלה מבולבלה מבולבלה participle feminine plural construct any unspecified  	O	null

0 מן מן מן preposition unspecified unspecified unspecified unspecified unspecified  	O	null

0 ה ה הריקוד definiteArticle unspecified unspecified unspecified unspecified unspecified 0 
0 הריקוד ריקוד הריקוד noun masculine singular absolute unspecified unspecified  	O	null

0 דודי דודי דודי properName unspecified unspecified unspecified unspecified unspecified  	O	null

0 מ מ מדוד preposition unspecified unspecified unspecified unspecified unspecified 0 
0 דוד דוד מדוד properName unspecified unspecified unspecified unspecified unspecified  	I_PERS	null

0 חמוד חמוד חמוד properName unspecified unspecified unspecified unspecified unspecified  	I_PERS	null

0 האין האין האין interrogative unspecified unspecified unspecified unspecified unspecified  	O	null

0 זו זו זו pronoun feminine singular unspecified 3 unspecified  	O	null

0 אגדה אגדה אגדה noun feminine singular absolute unspecified unspecified  	O	null

0 אני הוא אני pronoun masculine-and-feminine singular unspecified 1 unspecified  	O	null

0 ו ו ואת conjunction unspecified unspecified unspecified unspecified unspecified 0 
0 את את ואת at-preposition unspecified unspecified unspecified unspecified unspecified  	O	null

0 לבד לבד לבד adverb unspecified unspecified unspecified unspecified unspecified  	O	null

0 כאן כאן כאן adverb unspecified unspecified unspecified unspecified unspecified  	O	null

0 על על על preposition unspecified unspecified unspecified unspecified unspecified  	O	null

0 ה ה הגג definiteArticle unspecified unspecified unspecified unspecified unspecified 0 
0 הגג גג הגג noun masculine singular absolute unspecified unspecified  	O	null

0 ה ה הזהו definiteArticle unspecified unspecified unspecified unspecified unspecified 0 
0 הזהו הזהו הזהו noun masculine singular absolute unspecified unspecified  	O	null

0 ה ה האח definiteArticle unspecified unspecified unspecified unspecified unspecified 0 
0 האח אח האח noun masculine singular absolute unspecified unspecified  	O	null

0 דוד דוד דוד properName unspecified unspecified unspecified unspecified unspecified  	I_PERS	null

0 שמש שמש שמש properName unspecified unspecified unspecified unspecified unspecified  	I_PERS	null

0 ל ל לאנטנה preposition unspecified unspecified unspecified unspecified unspecified 0 
0 אנטנה אנטנה לאנטנה noun feminine singular absolute unspecified unspecified  	O	null

0 שח שח שח noun masculine singular absolute unspecified unspecified  	O	null

0 כמו כמו כמו preposition unspecified unspecified unspecified unspecified unspecified  	O	null

0 אינסטלטור אינסטלטור אינסטלטור noun masculine singular absolute unspecified unspecified  	O	null

0 פתי פתי פתי noun masculine singular construct unspecified unspecified  	O	null

0 התאהבת התאהב התאהבת verb feminine singular unspecified 2 past  	O	null

0 ב ב בך preposition unspecified unspecified unspecified unspecified unspecified  
0 ך ך בך pronomial masculine singular unspecified 2 unspecified 0 	O	null

0 אני הוא אני pronoun masculine-and-feminine singular unspecified 1 unspecified  	O	null

0 חושב חשב חושב verb masculine singular unspecified any beinoni  	O	null

0 ש ש שבחיי relativizer/subordinatingConjunction unspecified unspecified unspecified unspecified unspecified 0 
0 ב ב שבחיי preposition unspecified unspecified unspecified unspecified unspecified 0 
0 חיי חיים שבחיי noun masculine plural construct unspecified unspecified  	O	null

0 מקרה מקרה מקרה noun masculine singular absolute unspecified unspecified  	O	null

0 מוצלח מוצלח מוצלח adjective masculine singular absolute unspecified unspecified  	O	null

0 כל כול כל quantifier unspecified unspecified construct unspecified unspecified  	O	null

0 כך כך כך adverb unspecified unspecified unspecified unspecified unspecified  	O	null

0 כול כול כולי quantifier unspecified unspecified unspecified unspecified unspecified  
0 י י כולי pronomial masculine-and-feminine singular unspecified 1 unspecified 0 	O	null

0 טובלת טבל טובלת verb feminine singular unspecified any beinoni  	O	null

0 ל ל לי preposition unspecified unspecified unspecified unspecified unspecified  
0 י י לי pronomial masculine-and-feminine singular unspecified 1 unspecified 0 	O	null

0 ב ב בגל preposition unspecified unspecified unspecified unspecified unspecified 0 
0 גל גל בגל noun masculine singular absolute unspecified unspecified  	O	null

0 הקל הקל הקל verb masculine singular unspecified 3 past  	O	null

0 ו ו ולי conjunction unspecified unspecified unspecified unspecified unspecified 0 
0 ל ל ולי preposition unspecified unspecified unspecified unspecified unspecified  
0 י י ולי pronomial masculine-and-feminine singular unspecified 1 unspecified 0 	O	null

0 ב ב ברגש preposition unspecified unspecified unspecified unspecified unspecified 0 
0 רגש רגש ברגש noun masculine singular absolute unspecified unspecified  	O	null

0 כמו כמו כמו preposition unspecified unspecified unspecified unspecified unspecified  	O	null

0 מכת מכה מכת noun feminine singular construct unspecified unspecified  	O	null

0 חשמל חשמל חשמל noun masculine singular absolute unspecified unspecified  	O	null

0 דבר דבר דבר noun masculine singular absolute unspecified unspecified  	O	null

0 כ כ כזה preposition unspecified unspecified unspecified unspecified unspecified 0 
0 זה זה כזה pronoun masculine singular unspecified 3 unspecified  	O	null

0 עוד עוד עוד adverb unspecified unspecified unspecified unspecified unspecified  	O	null

0 לא לא לא negation unspecified unspecified unspecified unspecified unspecified  	O	null

0 קרה קרה קרה verb masculine singular unspecified 3 past  	O	null

0 ל ל לי preposition unspecified unspecified unspecified unspecified unspecified  
0 י י לי pronomial masculine-and-feminine singular unspecified 1 unspecified 0 	O	null

0 ענן ענן ענן noun masculine singular absolute unspecified unspecified  	O	null

0 את את את at-preposition unspecified unspecified unspecified unspecified unspecified  	O	null

0 ה ה השמיים definiteArticle unspecified unspecified unspecified unspecified unspecified 0 
0 השמיים שמיים השמיים noun masculine plural absolute unspecified unspecified  	O	null

0 לא לא לא negation unspecified unspecified unspecified unspecified unspecified  	O	null

0 יעיב העיב יעיב verb masculine singular unspecified 3 future  	O	null

0 כ כ כשעל preposition unspecified unspecified unspecified unspecified unspecified 0 
0 שעל שעל כשעל noun masculine singular absolute unspecified unspecified  	O	null

0 ראש ראש ראשנו noun masculine singular absolute unspecified unspecified  
0 נו נו ראשנו possessive masculine-and-feminine plural unspecified 1 unspecified 0 	O	null

0 ה ה הדרורים definiteArticle unspecified unspecified unspecified unspecified unspecified 0 
0 הדרורים דרור הדרורים noun masculine plural absolute unspecified unspecified  	O	null

0 מחרבנים חרבן מחרבנים verb masculine plural unspecified any beinoni  	O	null

0 אביב אביב אביב properName unspecified unspecified unspecified unspecified unspecified  	I_PERS	null

0 ו ו ולא conjunction unspecified unspecified unspecified unspecified unspecified 0 
0 לא לא ולא negation unspecified unspecified unspecified unspecified unspecified  	O	null

0 איכפת אכפת איכפת adverb unspecified unspecified unspecified unspecified unspecified  	O	null

0 ל ל לי preposition unspecified unspecified unspecified unspecified unspecified  
0 י י לי pronomial masculine-and-feminine singular unspecified 1 unspecified 0 	O	null

0 מ מ מהכביסה preposition unspecified unspecified unspecified unspecified unspecified 0 
0 ה ה מהכביסה definiteArticle unspecified unspecified unspecified unspecified unspecified 0 
0 הכביסה כביסה מהכביסה noun feminine singular absolute unspecified unspecified  	O	null

0 ו ו והשכנים conjunction unspecified unspecified unspecified unspecified unspecified 0 
0 ה ה והשכנים definiteArticle unspecified unspecified unspecified unspecified unspecified 0 
0 השכנים שכן והשכנים noun masculine plural absolute unspecified unspecified  	O	null

0 ש ש שמסביב relativizer/subordinatingConjunction unspecified unspecified unspecified unspecified unspecified 0 
0 מסביב מסביב שמסביב adverb unspecified unspecified unspecified unspecified unspecified  	O	null

0 חביב חביב חביב properName unspecified unspecified unspecified unspecified unspecified  	I_PERS	null

0 דוד דוד דוד properName unspecified unspecified unspecified unspecified unspecified  	I_PERS	null

0 שמש שמש שמש properName unspecified unspecified unspecified unspecified unspecified  	I_PERS	null

0 ו ו ואנטנה conjunction unspecified unspecified unspecified unspecified unspecified 0 
0 אנטנה אנטנה ואנטנה noun feminine singular absolute unspecified unspecified  	O	null

0 ב ב בראש preposition unspecified unspecified unspecified unspecified unspecified 0 
0 ראש ראש בראש noun masculine singular absolute unspecified unspecified  	O	null

0 גג גג גג noun masculine singular absolute unspecified unspecified  	O	null

0 הו הו הו interjection unspecified unspecified unspecified unspecified unspecified  	O	null

0 חג חג חג noun masculine singular construct unspecified unspecified  	O	null

0 - - - punctuation unspecified unspecified unspecified unspecified unspecified  	O	null

0 שמח שמח שמח adjective masculine singular absolute unspecified unspecified  	O	null

0 לא לא לא negation unspecified unspecified unspecified unspecified unspecified  	O	null

0 נורמלי נורמלי נורמלי adjective masculine singular absolute unspecified unspecified  	O	null

