0 מ מ מנהר preposition unspecified unspecified unspecified unspecified unspecified 0 
0 נהר נהר מנהר noun masculine singular construct unspecified unspecified  	O	null

0 ירקון ירקון ירקון noun masculine singular absolute unspecified unspecified  	O	null

0 עד עד עד noun masculine singular absolute unspecified unspecified  	O	null

0 הסמבטיון הסמבטיון הסמבטיון properName unspecified unspecified unspecified unspecified unspecified  	O	null

0 מ מ מגליל preposition unspecified unspecified unspecified unspecified unspecified 0 
0 גליל גליל מגליל noun masculine singular absolute unspecified unspecified  	O	null

0 עד עד עד noun masculine singular absolute unspecified unspecified  	O	null

0 ל ל לראש preposition unspecified unspecified unspecified unspecified unspecified 0 
0 ראש ראש לראש noun masculine singular absolute unspecified unspecified  	O	null

0 שטן שטן שטן noun masculine singular absolute unspecified unspecified  	O	null

0 לא לא לא negation unspecified unspecified unspecified unspecified unspecified  	O	null

0 תמצא מצא תמצא verb feminine singular unspecified 3 future  	O	null

0 תמה תמה תמה noun masculine singular construct unspecified unspecified  	O	null

0 כמו כמו כמו preposition unspecified unspecified unspecified unspecified unspecified  	O	null

0 את את אותה at-preposition unspecified unspecified unspecified unspecified unspecified  
0 ה ה אותה pronomial feminine singular unspecified 3 unspecified 0 	O	null

0 עלמה עלמה עלמה properName masculine singular unspecified unspecified unspecified  	I_PERS	null

0 היא הוא היא pronoun feminine singular unspecified 3 unspecified  	O	null

0 ה ה הכוכב definiteArticle unspecified unspecified unspecified unspecified unspecified 0 
0 הכוכב כוכב הכוכב noun masculine singular absolute unspecified unspecified  	O	null

0 של של של shel-preposition unspecified unspecified unspecified unspecified unspecified  	O	null

0 מחוז מחוז מחוז noun masculine singular construct unspecified unspecified  	O	null

0 גוש גוש גוש noun masculine singular construct unspecified unspecified  	O	null

0 דן דן דן properName unspecified unspecified unspecified unspecified unspecified  	I_PERS	null

