0 התנערי התנער התנערי verb feminine singular unspecified 2 imperative  	O	null

0 מ מ מעפר preposition unspecified unspecified unspecified unspecified unspecified 0 
0 עפר עפר מעפר noun masculine singular absolute unspecified unspecified  	O	null

0 קומי קומי קומי adjective masculine singular absolute unspecified unspecified  	O	null

0 לבשי לבש לבשי verb feminine singular unspecified 2 imperative  	O	null

0 בגדי בגד בגדי noun masculine plural construct unspecified unspecified  	O	null

0 תפארת תפארת תפארתך noun feminine singular absolute unspecified unspecified  
0 ך ך תפארתך possessive feminine singular unspecified 2 unspecified 0 	O	null

0 עמי עם עמי noun masculine plural construct unspecified unspecified  	O	null

0 על על על preposition unspecified unspecified unspecified unspecified unspecified  	O	null
1 - - - punctuation unspecified unspecified unspecified unspecified unspecified  	O	null
2 יד יד יד noun feminine singular construct unspecified unspecified  	O	null

0 בן בן בן properName unspecified unspecified unspecified unspecified unspecified  	I_PERS	null
1 - - - properName unspecified unspecified unspecified unspecified unspecified  	I_PERS	null
2 ישי ישי ישי properName unspecified unspecified unspecified unspecified unspecified  	I_PERS	null

0 בית בית בית noun masculine singular construct unspecified unspecified  	O	null

0 הלחמי הלחם הלחמי noun masculine plural construct unspecified unspecified  	O	null

0 קרב קרב קרבה noun masculine singular absolute unspecified unspecified  
0 ה ה קרבה possessive feminine singular unspecified 3 unspecified 0 	O	null

0 אל אל אל preposition unspecified unspecified unspecified unspecified unspecified  	O	null
1 - - - punctuation unspecified unspecified unspecified unspecified unspecified  	O	null
2 נפשי נפשי נפשי adjective masculine singular absolute unspecified unspecified  	O	null

0 גאלה גאלה גאלה noun feminine singular absolute unspecified unspecified  	O	null

