0 ה ה הקהל definiteArticle unspecified unspecified unspecified unspecified unspecified 0 
0 הקהל קהל הקהל noun masculine singular absolute unspecified unspecified  	O	null

0 התפזר התפזר התפזר verb masculine singular unspecified 3 past  	O	null

0 ה ה הנגנים definiteArticle unspecified unspecified unspecified unspecified unspecified 0 
0 הנגנים נגן הנגנים noun masculine plural absolute unspecified unspecified  	O	null

0 נבלעו נבלע נבלעו verb masculine-and-feminine plural unspecified 3 past  	O	null

0 ב ב במונית preposition unspecified unspecified unspecified unspecified unspecified 0 
0 מונית מונית במונית noun feminine singular absolute unspecified unspecified  	O	null

0 יוסף יוסף יוסף properName unspecified unspecified unspecified unspecified unspecified  	I_PERS	null

0 שאול שאול שאול properName unspecified unspecified unspecified unspecified unspecified  	I_PERS	null

0 ו ו ואני conjunction unspecified unspecified unspecified unspecified unspecified 0 
0 אני הוא ואני pronoun masculine-and-feminine singular unspecified 1 unspecified  	O	null

0 מקפלים קיפל מקפלים verb masculine plural unspecified any beinoni  	O	null

0 את את את at-preposition unspecified unspecified unspecified unspecified unspecified  	O	null

0 ה ה הבמה definiteArticle unspecified unspecified unspecified unspecified unspecified 0 
0 הבמה במה הבמה noun feminine singular absolute unspecified unspecified  	O	null

0 אל אל אל preposition unspecified unspecified unspecified unspecified unspecified  	O	null

0 תוך תוך תוך noun masculine singular construct unspecified unspecified  	O	null

0 ה ה המשאית definiteArticle unspecified unspecified unspecified unspecified unspecified 0 
0 המשאית משאית המשאית noun feminine singular absolute unspecified unspecified  	O	null

0 שקט שקט שקט noun masculine singular absolute unspecified unspecified  	O	null

0 של של של shel-preposition unspecified unspecified unspecified unspecified unspecified  	O	null

0 אחרי אחרי אחרי preposition unspecified unspecified unspecified unspecified unspecified  	O	null

0 ה ה הסערה definiteArticle unspecified unspecified unspecified unspecified unspecified 0 
0 הסערה סערה הסערה noun feminine singular absolute unspecified unspecified  	O	null

0 יורד יורד יורד noun masculine singular absolute unspecified unspecified  	O	null

0 על על על preposition unspecified unspecified unspecified unspecified unspecified  	O	null

0 ה ה האולם definiteArticle unspecified unspecified unspecified unspecified unspecified 0 
0 האולם אולם האולם noun masculine singular absolute unspecified unspecified  	O	null

0 ו ו ועל conjunction unspecified unspecified unspecified unspecified unspecified 0 
0 על על ועל preposition unspecified unspecified unspecified unspecified unspecified  	O	null

0 ה ה הבמה definiteArticle unspecified unspecified unspecified unspecified unspecified 0 
0 הבמה במה הבמה noun feminine singular absolute unspecified unspecified  	O	null

0 יוסף יוסף יוסף properName unspecified unspecified unspecified unspecified unspecified  	I_PERS	null

0 סופר סופר סופר noun masculine singular absolute unspecified unspecified  	O	null

0 את את את at-preposition unspecified unspecified unspecified unspecified unspecified  	O	null

0 ה ה הפנסים definiteArticle unspecified unspecified unspecified unspecified unspecified 0 
0 הפנסים פנס הפנסים noun masculine plural absolute unspecified unspecified  	O	null

0 שאול שאול שאול properName unspecified unspecified unspecified unspecified unspecified  	I_PERS	null

0 ו ו ואני conjunction unspecified unspecified unspecified unspecified unspecified 0 
0 אני הוא ואני pronoun masculine-and-feminine singular unspecified 1 unspecified  	O	null

0 מקפלים קיפל מקפלים verb masculine plural unspecified any beinoni  	O	null

0 את את את at-preposition unspecified unspecified unspecified unspecified unspecified  	O	null

0 ה ה הבדים definiteArticle unspecified unspecified unspecified unspecified unspecified 0 
0 הבדים בד הבדים noun masculine plural absolute unspecified unspecified  	O	null

0 שורה שורה שורה noun feminine singular absolute unspecified unspecified  	O	null

0 של של של shel-preposition unspecified unspecified unspecified unspecified unspecified  	O	null

0 ארגזים ארגז ארגזים noun masculine plural absolute unspecified unspecified  	O	null

0 מסודרים מסודר מסודרים adjective masculine plural absolute unspecified unspecified  	O	null

0 קו קו קו noun masculine singular construct unspecified unspecified  	O	null

0 ישר ישר ישר adverb unspecified unspecified unspecified unspecified unspecified  	O	null

0 ב ב בראש preposition unspecified unspecified unspecified unspecified unspecified 0 
0 ראש ראש בראש noun masculine singular absolute unspecified unspecified  	O	null

0 מהדהד הידהד מהדהד verb masculine singular unspecified any beinoni  	O	null

0 ה ה המופע definiteArticle unspecified unspecified unspecified unspecified unspecified 0 
0 המופע מופע המופע noun masculine singular absolute unspecified unspecified  	O	null

0 שהיה שהייה שהיה noun feminine singular absolute unspecified unspecified  	O	null

0 ש ש שנגמר relativizer/subordinatingConjunction unspecified unspecified unspecified unspecified unspecified 0 
0 נגמר נגמר שנגמר verb masculine singular unspecified 3 past  	O	null

0 כש כש כשנגמור temporalSubConj unspecified unspecified unspecified unspecified unspecified 0 
0 נגמור גמר כשנגמור verb masculine-and-feminine plural unspecified 1 future  	O	null

0 להעמיס העמיס להעמיס verb unspecified unspecified unspecified unspecified infinitive  	O	null

0 נצא יצא נצא verb masculine-and-feminine plural unspecified 1 future  	O	null

0 ל ל לדרך preposition unspecified unspecified unspecified unspecified unspecified 0 
0 דרך דרך לדרך noun feminine singular construct unspecified unspecified  	O	null

0 ה ה השחר definiteArticle unspecified unspecified unspecified unspecified unspecified 0 
0 השחר שחר השחר noun masculine singular absolute unspecified unspecified  	O	null

0 מתחיל התחיל מתחיל verb masculine singular unspecified any beinoni  	O	null

0 ל ל לעלות preposition unspecified unspecified unspecified unspecified unspecified 0 
0 עלות עלות לעלות noun feminine singular construct unspecified unspecified  	O	null

0 יוסף יוסף יוסף properName unspecified unspecified unspecified unspecified unspecified  	I_PERS	null

0 עם עם עם preposition unspecified unspecified unspecified unspecified unspecified  	O	null

0 ה ה הקוניאק definiteArticle unspecified unspecified unspecified unspecified unspecified 0 
0 הקוניאק הקוניאק הקוניאק noun masculine singular absolute unspecified unspecified  	O	null

0 מתחיל התחיל מתחיל verb masculine singular unspecified any beinoni  	O	null

0 ל ל לדבר preposition unspecified unspecified unspecified unspecified unspecified 0 
0 דבר דבר לדבר noun masculine singular absolute unspecified unspecified  	O	null

0 שטויות שטות שטויות noun feminine plural absolute unspecified unspecified  	O	null

0 הוא הוא הוא pronoun masculine singular unspecified 3 unspecified  	O	null

0 אומר אמר אומר verb masculine singular unspecified any beinoni  	O	null

0 ש ש שנמאס relativizer/subordinatingConjunction unspecified unspecified unspecified unspecified unspecified 0 
0 נמאס נמאס שנמאס verb masculine singular unspecified 3 past  	O	null

0 לו לו לו conjunction unspecified unspecified unspecified unspecified unspecified  	O	null

0 ה ה הלילה definiteArticle unspecified unspecified unspecified unspecified unspecified 0 
0 הלילה לילה הלילה noun masculine singular absolute unspecified unspecified  	O	null

0 ה ה הפחד definiteArticle unspecified unspecified unspecified unspecified unspecified 0 
0 הפחד פחד הפחד noun masculine singular absolute unspecified unspecified  	O	null

0 ו ו והכביש conjunction unspecified unspecified unspecified unspecified unspecified 0 
0 ה ה והכביש definiteArticle unspecified unspecified unspecified unspecified unspecified 0 
0 הכביש כביש והכביש noun masculine singular absolute unspecified unspecified  	O	null

0 ה ה השחור definiteArticle unspecified unspecified unspecified unspecified unspecified 0 
0 השחור שחור השחור adjective masculine singular absolute unspecified unspecified  	O	null

0 ו ו ושמחר conjunction unspecified unspecified unspecified unspecified unspecified 0 
0 ש ש ושמחר relativizer/subordinatingConjunction unspecified unspecified unspecified unspecified unspecified 0 
0 מחר מחר ושמחר adverb unspecified unspecified unspecified unspecified unspecified  	O	null

0 ב ב בשלוש preposition unspecified unspecified unspecified unspecified unspecified 0 
0 שלוש CARD3 בשלוש numeral feminine singular absolute unspecified unspecified  	O	null

0 יוצאים יצא יוצאים verb masculine plural unspecified any beinoni  	O	null

0 ל ל לעוד preposition unspecified unspecified unspecified unspecified unspecified 0 
0 עוד עוד לעוד noun masculine singular construct unspecified unspecified  	O	null

0 הופעה הופעה הופעה noun feminine singular absolute unspecified unspecified  	O	null

0 ב ב בחצור preposition unspecified unspecified unspecified unspecified unspecified 0 
0 חצור חצור בחצור properName unspecified unspecified unspecified unspecified unspecified  	I_LOC	null

0 צמת צמה צמת noun feminine singular construct unspecified unspecified  	O	null

0 קסטינה קסטינה קסטינה noun masculine singular absolute unspecified unspecified  	O	null

0 חשוך חשוך חשוך adjective masculine singular absolute unspecified unspecified  	O	null

0 ו ו ואדיש conjunction unspecified unspecified unspecified unspecified unspecified 0 
0 אדיש אדיש ואדיש adjective masculine singular absolute unspecified unspecified  	O	null

0 כל כול כל quantifier unspecified unspecified construct unspecified unspecified  	O	null

0 ה ה העולם definiteArticle unspecified unspecified unspecified unspecified unspecified 0 
0 העולם עולם העולם noun masculine singular absolute unspecified unspecified  	O	null

0 ישן ישן ישן adjective masculine singular absolute unspecified unspecified  	O	null

0 רק רק רק conjunction unspecified unspecified unspecified unspecified unspecified  	O	null

0 אנחנו הוא אנחנו pronoun masculine-and-feminine plural unspecified 1 unspecified  	O	null

0 על על על preposition unspecified unspecified unspecified unspecified unspecified  	O	null

0 ה ה הכביש definiteArticle unspecified unspecified unspecified unspecified unspecified 0 
0 הכביש כביש הכביש noun masculine singular absolute unspecified unspecified  	O	null

0 ו ו ואני conjunction unspecified unspecified unspecified unspecified unspecified 0 
0 אני הוא ואני pronoun masculine-and-feminine singular unspecified 1 unspecified  	O	null

0 נרדם נרדם נרדם verb masculine singular unspecified 3 past  	O	null

0 על על על preposition unspecified unspecified unspecified unspecified unspecified  	O	null

0 ה ה הכבלים definiteArticle unspecified unspecified unspecified unspecified unspecified 0 
0 הכבלים כבל הכבלים noun masculine plural absolute unspecified unspecified  	O	null

0 מאחור מאחור מאחור adverb unspecified unspecified unspecified unspecified unspecified  	O	null

0 שומע שמע שומע verb masculine singular unspecified any beinoni  	O	null

0 איך איך איך adverb unspecified unspecified unspecified unspecified unspecified  	O	null

0 שאול שאול שאול properName unspecified unspecified unspecified unspecified unspecified  	I_PERS	null

0 צועק צעק צועק verb masculine singular unspecified any beinoni  	O	null

0 על על על preposition unspecified unspecified unspecified unspecified unspecified  	O	null

0 יוסף יוסף יוסף properName unspecified unspecified unspecified unspecified unspecified  	I_PERS	null

0 איך איך איך adverb unspecified unspecified unspecified unspecified unspecified  	O	null

0 אתה הוא אתה pronoun masculine singular unspecified 2 unspecified  	O	null

0 נוהג נוהג נוהג noun masculine singular absolute unspecified unspecified  	O	null

0 יה יה יה properName unspecified unspecified unspecified unspecified unspecified  	O	null

0 שיכור שיכור שיכור noun masculine singular absolute unspecified unspecified  	O	null

0 עכשיו עכשיו עכשיו adverb unspecified unspecified unspecified unspecified unspecified  	O	null

0 שאול שאול שאול properName unspecified unspecified unspecified unspecified unspecified  	I_PERS	null

0 שר שר שר noun masculine singular construct unspecified unspecified  	O	null

0 צל צל צל noun masculine singular absolute unspecified unspecified  	O	null

0 עץ עץ עץ noun masculine singular absolute unspecified unspecified  	O	null

0 תמר תמר תמר properName feminine singular unspecified unspecified unspecified  	I_PERS	null

0 ו ו ואור conjunction unspecified unspecified unspecified unspecified unspecified 0 
0 אור אור ואור noun masculine singular absolute unspecified unspecified  	O	null

0 ירח ירח ירח noun masculine singular absolute unspecified unspecified  	O	null

0 ו ו ויוסף conjunction unspecified unspecified unspecified unspecified unspecified 0 
0 יוסף יוסף ויוסף properName unspecified unspecified unspecified unspecified unspecified  	I_PERS	null

0 מחליף מחליף מחליף noun masculine singular absolute unspecified unspecified  	O	null

0 מהלך מהלך מהלך noun masculine singular construct unspecified unspecified  	O	null

0 מקלל קילל מקלל verb masculine singular unspecified any beinoni  	O	null

0 ו ו וגונח conjunction unspecified unspecified unspecified unspecified unspecified 0 
0 גונח גנח וגונח verb masculine singular unspecified any beinoni  	O	null

