0 אהלן אהלן אהלן interjection unspecified unspecified unspecified unspecified unspecified  	O	null

0 גרישה גרישה גרישה noun feminine singular absolute unspecified unspecified  	O	null

0 אהלן אהלן אהלן interjection unspecified unspecified unspecified unspecified unspecified  	O	null

0 פנטה פנטה פנטה noun masculine singular absolute unspecified unspecified  	O	null

0 ברוך ברוך ברוך properName unspecified unspecified unspecified unspecified unspecified  	I_PERS	null

0 ה ה הבא definiteArticle unspecified unspecified unspecified unspecified unspecified 0 
0 הבא בא הבא adjective masculine singular absolute unspecified unspecified  	O	null

0 ל ל לישראל preposition unspecified unspecified unspecified unspecified unspecified 0 
0 ישראל ישראל לישראל properName unspecified unspecified unspecified unspecified unspecified  	I_LOC	null

0 ל ל לכבודך preposition unspecified unspecified unspecified unspecified unspecified 0 
0 כבוד כבוד לכבודך noun masculine singular absolute unspecified unspecified  
0 ך ך לכבודך possessive feminine singular unspecified 2 unspecified 0 	O	null

0 ארצי ארצי ארצי properName unspecified unspecified unspecified unspecified unspecified  	I_PERS	null

0 נרגשה נרגשה נרגשה verb masculine-and-feminine plural unspecified 1 future  	O	null

0 עד עד עד noun masculine singular absolute unspecified unspecified  	O	null

0 ש ש שאתה relativizer/subordinatingConjunction unspecified unspecified unspecified unspecified unspecified 0 
0 אתה הוא שאתה pronoun masculine singular unspecified 2 unspecified  	O	null

0 תתרגל תרגל תתרגל verb feminine singular unspecified 3 future  	O	null

0 כל כול כל quantifier unspecified unspecified construct unspecified unspecified  	O	null

0 ה ה העם definiteArticle unspecified unspecified unspecified unspecified unspecified 0 
0 העם עם העם noun masculine singular absolute unspecified unspecified  	O	null

0 ב ב בקול preposition unspecified unspecified unspecified unspecified unspecified 0 
0 קול קול בקול noun masculine singular construct unspecified unspecified  	O	null

0 אדיר אדיר אדיר adjective masculine singular absolute unspecified unspecified  	O	null

0 לקראת לקראת לקראתך preposition unspecified unspecified unspecified unspecified unspecified  
0 ך ך לקראתך pronomial masculine singular unspecified 2 unspecified 0 	O	null

0 תמיד תמיד תמיד adverb unspecified unspecified unspecified unspecified unspecified  	O	null

0 ישיר ישיר ישיר adjective masculine singular absolute unspecified unspecified  	O	null

0 את את את at-preposition unspecified unspecified unspecified unspecified unspecified  	O	null

0 ה ה הלב definiteArticle unspecified unspecified unspecified unspecified unspecified 0 
0 הלב לב הלב noun masculine singular absolute unspecified unspecified  	O	null

0 לך הלך לך verb masculine singular unspecified 2 imperative  	O	null

0 פותח פותח פותח verb masculine singular unspecified 3 past  	O	null

0 בוא בוא בוא noun masculine singular construct unspecified unspecified  	O	null

0 ו ו ותעלה conjunction unspecified unspecified unspecified unspecified unspecified 0 
0 תעלה תעלה ותעלה noun feminine singular absolute unspecified unspecified  	O	null

