0 Bee Bee Bee foreign unspecified unspecified unspecified unspecified unspecified  	I_ORG	null

0 I I I foreign unspecified unspecified unspecified unspecified unspecified  	I_ORG	null

0 m m m foreign unspecified unspecified unspecified unspecified unspecified  	I_ORG	null

0 expecting expecting expecting foreign unspecified unspecified unspecified unspecified unspecified  	I_ORG	null

0 you you you foreign unspecified unspecified unspecified unspecified unspecified  	I_ORG	null

0 Was Was Was foreign unspecified unspecified unspecified unspecified unspecified  	I_ORG	null

0 saying saying saying foreign unspecified unspecified unspecified unspecified unspecified  	I_ORG	null

0 Yesterday Yesterday Yesterday foreign unspecified unspecified unspecified unspecified unspecified  	I_ORG	null

0 To To To foreign unspecified unspecified unspecified unspecified unspecified  	I_ORG	null

0 Somebody Somebody Somebody foreign unspecified unspecified unspecified unspecified unspecified  	I_ORG	null

0 you you you foreign unspecified unspecified unspecified unspecified unspecified  	I_ORG	null

0 know know know foreign unspecified unspecified unspecified unspecified unspecified  	I_ORG	null

0 That That That foreign unspecified unspecified unspecified unspecified unspecified  	I_ORG	null

0 you you you foreign unspecified unspecified unspecified unspecified unspecified  	I_ORG	null

0 were were were foreign unspecified unspecified unspecified unspecified unspecified  	I_ORG	null

0 due due due foreign unspecified unspecified unspecified unspecified unspecified  	O	null
1 — — — punctuation unspecified unspecified unspecified unspecified unspecified  	O	null

0 The The The foreign unspecified unspecified unspecified unspecified unspecified  	I_ORG	null

0 Frogs Frogs Frogs foreign unspecified unspecified unspecified unspecified unspecified  	I_ORG	null

0 got got got foreign unspecified unspecified unspecified unspecified unspecified  	I_ORG	null

0 Home Home Home foreign unspecified unspecified unspecified unspecified unspecified  	I_ORG	null

0 last last last foreign unspecified unspecified unspecified unspecified unspecified  	I_ORG	null

0 Week Week Week foreign unspecified unspecified unspecified unspecified unspecified  	O	null
1 — — — punctuation unspecified unspecified unspecified unspecified unspecified  	O	null

0 Are Are Are foreign unspecified unspecified unspecified unspecified unspecified  	I_ORG	null

0 settled settled settled foreign unspecified unspecified unspecified unspecified unspecified  	I_ORG	null

0 and and and foreign unspecified unspecified unspecified unspecified unspecified  	I_ORG	null

0 at at at foreign unspecified unspecified unspecified unspecified unspecified  	I_ORG	null

0 work work work foreign unspecified unspecified unspecified unspecified unspecified  	O	null
1 — — — punctuation unspecified unspecified unspecified unspecified unspecified  	O	null

0 Birds Birds Birds foreign unspecified unspecified unspecified unspecified unspecified  	I_ORG	null

0 mostly mostly mostly foreign unspecified unspecified unspecified unspecified unspecified  	I_ORG	null

0 back back back foreign unspecified unspecified unspecified unspecified unspecified  	O	null
1 — — — punctuation unspecified unspecified unspecified unspecified unspecified  	O	null

0 The The The foreign unspecified unspecified unspecified unspecified unspecified  	I_ORG	null

0 Clover Clover Clover foreign unspecified unspecified unspecified unspecified unspecified  	I_ORG	null

0 warm warm warm foreign unspecified unspecified unspecified unspecified unspecified  	I_ORG	null

0 and and and foreign unspecified unspecified unspecified unspecified unspecified  	I_ORG	null

0 thick thick thick foreign unspecified unspecified unspecified unspecified unspecified  	O	null
1 — — — punctuation unspecified unspecified unspecified unspecified unspecified  	O	null

0 You You You foreign unspecified unspecified unspecified unspecified unspecified  	I_ORG	null

0 ll ll ll foreign unspecified unspecified unspecified unspecified unspecified  	I_ORG	null

0 get get get foreign unspecified unspecified unspecified unspecified unspecified  	I_ORG	null

0 my my my foreign unspecified unspecified unspecified unspecified unspecified  	I_ORG	null

0 Letter Letter Letter foreign unspecified unspecified unspecified unspecified unspecified  	I_ORG	null

0 by by by foreign unspecified unspecified unspecified unspecified unspecified  	I_ORG	null

0 The The The foreign unspecified unspecified unspecified unspecified unspecified  	I_ORG	null

0 seventeenth seventeenth seventeenth foreign unspecified unspecified unspecified unspecified unspecified  	O	null
1 ; ; ; punctuation unspecified unspecified unspecified unspecified unspecified  	O	null

0 Reply Reply Reply foreign unspecified unspecified unspecified unspecified unspecified  	I_ORG	null

0 Or Or Or foreign unspecified unspecified unspecified unspecified unspecified  	I_ORG	null

0 better better better foreign unspecified unspecified unspecified unspecified unspecified  	I_ORG	null

0 be be be foreign unspecified unspecified unspecified unspecified unspecified  	I_ORG	null

0 with with with foreign unspecified unspecified unspecified unspecified unspecified  	I_ORG	null

0 me me me foreign unspecified unspecified unspecified unspecified unspecified  	O	null
1 — — — punctuation unspecified unspecified unspecified unspecified unspecified  	O	null

0 Yours Yours Yours foreign unspecified unspecified unspecified unspecified unspecified  	I_ORG	null

0 Fly Fly Fly foreign unspecified unspecified unspecified unspecified unspecified  	I_ORG	null

