0 כי כי כי conjunction unspecified unspecified unspecified unspecified unspecified  	O	null

0 מ מ מציון preposition unspecified unspecified unspecified unspecified unspecified 0 
0 ציון ציון מציון properName unspecified unspecified unspecified unspecified unspecified  	I_PERS	null

0 תצא יצא תצא verb feminine singular unspecified 3 future  	O	null

0 תורה תורה תורה noun feminine singular absolute unspecified unspecified  	O	null

0 ו ו והיא conjunction unspecified unspecified unspecified unspecified unspecified 0 
0 היא הוא והיא pronoun feminine singular unspecified 3 unspecified  	O	null

0 תפיץ הפיץ תפיץ verb feminine singular unspecified 3 future  	O	null

0 את את את at-preposition unspecified unspecified unspecified unspecified unspecified  	O	null

0 ה ה הבשורה definiteArticle unspecified unspecified unspecified unspecified unspecified 0 
0 הבשורה בשורה הבשורה noun feminine singular absolute unspecified unspecified  	O	null

0 אז אז אז conjunction unspecified unspecified unspecified unspecified unspecified  	O	null

0 יפתחו פתח יפתחו verb masculine-and-feminine plural unspecified 3 future  	O	null

0 דלת דלת דלתי noun feminine singular absolute unspecified unspecified  
0 י י דלתי possessive masculine-and-feminine singular unspecified 1 unspecified 0 	O	null

0 מרום מרום מרום properName masculine singular unspecified unspecified unspecified  	I_PERS	null

0 ו ו ומארבע conjunction unspecified unspecified unspecified unspecified unspecified 0 
0 מ מ ומארבע preposition unspecified unspecified unspecified unspecified unspecified 0 
0 ארבע CARD4 ומארבע numeral feminine singular absolute unspecified unspecified  	O	null

0 כ כ כנפות preposition unspecified unspecified unspecified unspecified unspecified 0 
0 נפות נפה כנפות noun feminine plural absolute unspecified unspecified  	O	null

0 ה ה הארץ definiteArticle unspecified unspecified unspecified unspecified unspecified 0 
0 הארץ ארץ הארץ noun feminine singular absolute unspecified unspecified  	O	null

0 תגיע הגיע תגיע verb feminine singular unspecified 3 future  	O	null

0 חוכמה חוכמה חוכמה noun feminine singular absolute unspecified unspecified  	O	null

0 תגיע הגיע תגיע verb feminine singular unspecified 3 future  	O	null

0 בין בין בינה preposition unspecified unspecified unspecified unspecified unspecified  
0 ה ה בינה pronomial feminine singular unspecified 3 unspecified 0 	O	null

0 בלי בלי בלי preposition unspecified unspecified unspecified unspecified unspecified  	O	null

0 הקצנה הקצנה הקצנה noun feminine singular absolute unspecified unspecified  	O	null

0 של של של shel-preposition unspecified unspecified unspecified unspecified unspecified  	O	null

0 ה ה האמונה definiteArticle unspecified unspecified unspecified unspecified unspecified 0 
0 האמונה אמונה האמונה noun feminine singular absolute unspecified unspecified  	O	null

0 כל כול כל quantifier unspecified unspecified construct unspecified unspecified  	O	null

0 ה ה הגבולות definiteArticle unspecified unspecified unspecified unspecified unspecified 0 
0 הגבולות גבול הגבולות noun masculine plural absolute unspecified unspecified  	O	null

0 אז אז אז conjunction unspecified unspecified unspecified unspecified unspecified  	O	null

0 ייפרצו נפרץ ייפרצו verb masculine-and-feminine plural unspecified 3 future  	O	null

0 ו ו והאדם conjunction unspecified unspecified unspecified unspecified unspecified 0 
0 ה ה והאדם definiteArticle unspecified unspecified unspecified unspecified unspecified 0 
0 האדם אדם והאדם noun masculine singular absolute unspecified unspecified  	O	null

0 ישיר ישיר ישיר adjective masculine singular absolute unspecified unspecified  	O	null

0 ב ב באומץ preposition unspecified unspecified unspecified unspecified unspecified 0 
0 אומץ אומץ באומץ noun masculine singular absolute unspecified unspecified  	O	null

0 זאת זאת זאת pronoun feminine singular unspecified 3 unspecified  	O	null

0 ה ה הבשורה definiteArticle unspecified unspecified unspecified unspecified unspecified 0 
0 הבשורה בשורה הבשורה noun feminine singular absolute unspecified unspecified  	O	null

0 כל כול כל quantifier unspecified unspecified construct unspecified unspecified  	O	null

0 כך כך כך adverb unspecified unspecified unspecified unspecified unspecified  	O	null

0 יפה יפה יפה adverb unspecified unspecified unspecified unspecified unspecified  	O	null

0 נשלח נשלח נשלח verb masculine singular unspecified 3 past  	O	null

0 את את אותה at-preposition unspecified unspecified unspecified unspecified unspecified  
0 ה ה אותה pronomial feminine singular unspecified 3 unspecified 0 	O	null

0 ב ב במעטפה preposition unspecified unspecified unspecified unspecified unspecified 0 
0 מעטפה מעטפה במעטפה noun feminine singular absolute unspecified unspecified  	O	null

0 ב ב בדואר preposition unspecified unspecified unspecified unspecified unspecified 0 
0 ה ה בדואר definiteArticle unspecified unspecified unspecified unspecified unspecified 0 
0 הדואר דואר בדואר noun masculine singular absolute unspecified unspecified  	O	null

0 יונים יון יונים noun masculine plural absolute unspecified unspecified  	O	null

0 על על על preposition unspecified unspecified unspecified unspecified unspecified  	O	null

0 גב גב גב noun masculine singular absolute unspecified unspecified  	O	null

0 ה ה הגמלים definiteArticle unspecified unspecified unspecified unspecified unspecified 0 
0 הגמלים גמל הגמלים noun masculine plural absolute unspecified unspecified  	O	null

0 בתוך בתוך בתוך preposition unspecified unspecified unspecified unspecified unspecified  	O	null

0 בקבוק בקבוק בקבוק noun masculine singular absolute unspecified unspecified  	O	null

0 על על על preposition unspecified unspecified unspecified unspecified unspecified  	O	null

0 פני פני פני noun masculine singular absolute unspecified unspecified  	O	null

0 ה ה המים definiteArticle unspecified unspecified unspecified unspecified unspecified 0 
0 המים מים המים noun masculine plural absolute unspecified unspecified  	O	null

0 מ מ מדן preposition unspecified unspecified unspecified unspecified unspecified 0 
0 דן דן מדן properName unspecified unspecified unspecified unspecified unspecified  	I_PERS	null

0 עד עד עד noun masculine singular absolute unspecified unspecified  	O	null

0 אילת אילת אילת properName unspecified unspecified unspecified unspecified unspecified  	I_PERS	null

0 בין בין בין preposition unspecified unspecified unspecified unspecified unspecified  	O	null

0 עכו עכו עכו properName unspecified unspecified unspecified unspecified unspecified  	I_LOC	null

0 ל ל לצפת preposition unspecified unspecified unspecified unspecified unspecified 0 
0 צפת צף לצפת participle feminine singular construct any unspecified  	O	null

0 מ מ מתל preposition unspecified unspecified unspecified unspecified unspecified 0 
0 תל תל מתל noun masculine singular construct unspecified unspecified  	O	null

0 אביב אביב אביב properName unspecified unspecified unspecified unspecified unspecified  	I_PERS	null

0 עד עד עד noun masculine singular absolute unspecified unspecified  	O	null

0 ל ל לקריית preposition unspecified unspecified unspecified unspecified unspecified 0 
0 קריית קריה לקריית noun feminine singular construct unspecified unspecified  	O	null

0 גת גת גת properName unspecified unspecified unspecified unspecified unspecified  	I_PERS	null

0 מ מ ממצפה preposition unspecified unspecified unspecified unspecified unspecified 0 
0 מצפה מצפה ממצפה properName masculine singular unspecified unspecified unspecified  	O	null

0 רמון רמון רמון properName unspecified unspecified unspecified unspecified unspecified  	I_PERS	null

0 עד עד עד noun masculine singular absolute unspecified unspecified  	O	null

0 גבול גבול גבול noun masculine singular construct unspecified unspecified  	O	null

0 ה ה הצפון definiteArticle unspecified unspecified unspecified unspecified unspecified 0 
0 הצפון צפון הצפון noun masculine singular absolute unspecified unspecified  	O	null

0 ו ו ובחוצות conjunction unspecified unspecified unspecified unspecified unspecified 0 
0 ב ב ובחוצות preposition unspecified unspecified unspecified unspecified unspecified 0 
0 חוצות חוצות ובחוצות noun masculine plural absolute unspecified unspecified  	O	null

0 ירושלים ירושלים ירושלים properName unspecified unspecified unspecified unspecified unspecified  	I_LOC	null

0 ב ב ברכבת preposition unspecified unspecified unspecified unspecified unspecified 0 
0 רכבת רכבת ברכבת noun feminine singular construct unspecified unspecified  	O	null

0 אקספרס אקספרס אקספרס adjective masculine singular absolute unspecified unspecified  	O	null

0 עם עם עם preposition unspecified unspecified unspecified unspecified unspecified  	O	null

0 שמעון שמעון שמעון properName unspecified unspecified unspecified unspecified unspecified  	I_PERS	null

0 פרס פרס פרס properName unspecified unspecified unspecified unspecified unspecified  	I_PERS	null

0 ב ב בלילה preposition unspecified unspecified unspecified unspecified unspecified 0 
0 לילה לילה בלילה noun masculine singular absolute unspecified unspecified  	O	null

0 בהיר בהיר בהיר adjective masculine singular absolute unspecified unspecified  	O	null

0 נשיר נשיר נשיר adjective masculine singular absolute unspecified unspecified  	O	null

0 עד עד עד noun masculine singular absolute unspecified unspecified  	O	null

0 ל ל לקהיר preposition unspecified unspecified unspecified unspecified unspecified 0 
0 קהיר קהיר לקהיר properName unspecified unspecified unspecified unspecified unspecified  	I_LOC	null

0 משם משם משם adverb unspecified unspecified unspecified unspecified unspecified  	O	null

0 ל ל למרוקו preposition unspecified unspecified unspecified unspecified unspecified 0 
0 מרוקו מרוקו למרוקו properName unspecified unspecified unspecified unspecified unspecified  	I_LOC	null

0 תוניסיה תוניס תוניסיה properName unspecified unspecified unspecified unspecified unspecified  	I_LOC	null

0 אל אל אלג noun masculine singular absolute unspecified unspecified  
0 ה ה אלג possessive feminine singular unspecified 3 unspecified 0 	O	null

0 יר יר יר properName unspecified unspecified unspecified unspecified unspecified  	O	null

0 נביא נביא נביא noun masculine singular absolute unspecified unspecified  	O	null

0 פרחים פרח פרחים noun masculine plural absolute unspecified unspecified  	O	null

0 ב ב במקום preposition unspecified unspecified unspecified unspecified unspecified 0 
0 מקום מקום במקום noun masculine singular absolute unspecified unspecified  	O	null

0 עוד עוד עוד adverb unspecified unspecified unspecified unspecified unspecified  	O	null

0 נשק נשק נשק noun masculine singular absolute unspecified unspecified  	O	null

0 נטוס טס נטוס verb masculine-and-feminine plural unspecified 1 future  	O	null

0 ל ל לאירן preposition unspecified unspecified unspecified unspecified unspecified 0 
0 אירן איראן לאירן properName unspecified unspecified unspecified unspecified unspecified  	I_LOC	null

0 עם עם עם preposition unspecified unspecified unspecified unspecified unspecified  	O	null

0 אייבי אייבי אייבי properName unspecified unspecified unspecified unspecified unspecified  	I_PERS	null

0 נתן נתן נתן properName masculine singular unspecified unspecified unspecified  	I_PERS	null

0 נעיר העיר נעיר verb masculine-and-feminine plural unspecified 1 future  	O	null

0 אייטולות אייטולות אייטולות properName unspecified unspecified unspecified unspecified unspecified  	O	null

0 ב ב בטהרן preposition unspecified unspecified unspecified unspecified unspecified 0 
0 טהרן טהראן בטהרן properName feminine singular unspecified unspecified unspecified  	I_LOC	null

0 עורי עיוור עורי verb feminine singular unspecified 2 imperative  	O	null

0 תימן תימן תימן properName masculine singular unspecified unspecified unspecified  	I_LOC	null

0 עורי עיוור עורי verb feminine singular unspecified 2 imperative  	O	null

0 סודן סודן סודן properName unspecified unspecified unspecified unspecified unspecified  	I_LOC	null

0 עורי עיוור עורי verb feminine singular unspecified 2 imperative  	O	null

0 בגדד בגדאד בגדד properName unspecified unspecified unspecified unspecified unspecified  	I_LOC	null

0 ו ו וגם conjunction unspecified unspecified unspecified unspecified unspecified 0 
0 גם גם וגם conjunction unspecified unspecified unspecified unspecified unspecified  	O	null

0 דמשק דמשק דמשק properName unspecified unspecified unspecified unspecified unspecified  	I_LOC	null

