0 על על על preposition unspecified unspecified unspecified unspecified unspecified  	O	null

0 ברכי ברך ברכי noun feminine plural construct unspecified unspecified  	O	null

0 איך איך איך adverb unspecified unspecified unspecified unspecified unspecified  	O	null

0 נפלתי נפל נפלתי verb masculine-and-feminine singular unspecified 1 past  	O	null

0 ל ל לראותו preposition unspecified unspecified unspecified unspecified unspecified 0 
0 ראות ראות לראותו noun feminine singular absolute unspecified unspecified  
0 ו ו לראותו possessive masculine singular unspecified 3 unspecified 0 	O	null

0 שנית שנית שנית adverb unspecified unspecified unspecified unspecified unspecified  	O	null

0 בקשתי ביקש בקשתי verb masculine-and-feminine singular unspecified 1 past  	O	null

0 למה לאמה למה noun feminine singular absolute unspecified unspecified  	O	null

0 הם הוא הם pronoun masculine plural unspecified 3 unspecified  	O	null

0 הורסים הרס הורסים verb masculine plural unspecified any beinoni  	O	null

0 את את את at-preposition unspecified unspecified unspecified unspecified unspecified  	O	null

0 ה ה האהבה definiteArticle unspecified unspecified unspecified unspecified unspecified 0 
0 האהבה אהבה האהבה noun feminine singular absolute unspecified unspecified  	O	null

0 ב ב בסתרים preposition unspecified unspecified unspecified unspecified unspecified 0 
0 סתרים סתר בסתרים noun masculine plural absolute unspecified unspecified  	O	null

0 את את איתו at-preposition unspecified unspecified unspecified unspecified unspecified  
0 ו ו איתו pronomial masculine singular unspecified 3 unspecified 0 	O	null

0 הלכתי הלך הלכתי verb masculine-and-feminine singular unspecified 1 past  	O	null

0 ב ב בליבי preposition unspecified unspecified unspecified unspecified unspecified 0 
0 ליבי ליבי בליבי properName unspecified unspecified unspecified unspecified unspecified  	I_PERS	null

0 כאב כאב כאב noun masculine singular absolute unspecified unspecified  	I_DATE	null

0 הרגשתי הרגיש הרגשתי verb masculine-and-feminine singular unspecified 1 past  	O	null

0 יסוריי יסוריי יסוריי properName masculine singular unspecified unspecified unspecified  	O	null

0 ה ה האהבה definiteArticle unspecified unspecified unspecified unspecified unspecified 0 
0 האהבה אהבה האהבה noun feminine singular absolute unspecified unspecified  	O	null

