0 נגן נגן נגן noun masculine singular absolute unspecified unspecified  	O	null

0 נגן נגן נגנה noun masculine singular absolute unspecified unspecified  
0 ה ה נגנה possessive feminine singular unspecified 3 unspecified 0 	O	null

0 ל ל לקול preposition unspecified unspecified unspecified unspecified unspecified 0 
0 קול קול לקול noun masculine singular construct unspecified unspecified  	O	null

0 צליל צליל צלילך noun masculine singular absolute unspecified unspecified  
0 ך ך צלילך possessive feminine singular unspecified 2 unspecified 0 	O	null

0 מה מה מה interrogative unspecified unspecified unspecified unspecified unspecified  	O	null

0 נעים נעים נעים properName masculine singular unspecified unspecified unspecified  	I_PERS	null

0 הוא הוא הוא pronoun masculine singular unspecified 3 unspecified  	O	null

0 ה ה החלום definiteArticle unspecified unspecified unspecified unspecified unspecified 0 
0 החלום חלום החלום noun masculine singular absolute unspecified unspecified  	O	null

0 נגן נגן נגן noun masculine singular absolute unspecified unspecified  	O	null

0 נגן נגן נגנה noun masculine singular absolute unspecified unspecified  
0 ה ה נגנה possessive feminine singular unspecified 3 unspecified 0 	O	null

0 ישמע שמע ישמע verb masculine singular unspecified 3 future  	O	null

0 ירח ירח ירח noun masculine singular absolute unspecified unspecified  	O	null

0 את את את at-preposition unspecified unspecified unspecified unspecified unspecified  	O	null

0 קולי קולי קולי adjective masculine singular absolute unspecified unspecified  	O	null

0 שם שם שם adverb unspecified unspecified unspecified unspecified unspecified  	O	null

0 ב ב במרום preposition unspecified unspecified unspecified unspecified unspecified 0 
0 מרום מרום במרום properName masculine singular unspecified unspecified unspecified  	I_PERS	null

0 הוי הוי הוי verb masculine singular unspecified 2 imperative  	O	null

0 למה לאמה למה noun feminine singular absolute unspecified unspecified  	O	null

0 למה לאמה למה noun feminine singular absolute unspecified unspecified  	O	null

0 ב ב בשפתייך preposition unspecified unspecified unspecified unspecified unspecified 0 
0 שפתייך שפתייך בשפתייך noun feminine dual-and-plural absolute unspecified unspecified  	O	null

0 הקסמתני הקסמתני הקסמתני adjective masculine plural construct unspecified unspecified  	O	null

0 ליבי ליבי ליבי properName unspecified unspecified unspecified unspecified unspecified  	I_PERS	null

0 כבשת כבשה כבשת noun feminine singular construct unspecified unspecified  	O	null

0 ועזבתני ועזבתני ועזבתני adjective masculine plural construct unspecified unspecified  	O	null

0 אוהב אהב אוהב verb masculine singular unspecified any beinoni  	O	null

0 כואב כואב כואב adjective masculine singular absolute unspecified unspecified  	O	null

0 ו ו וסובל conjunction unspecified unspecified unspecified unspecified unspecified 0 
0 סובל סבל וסובל verb masculine singular unspecified any beinoni  	O	null

