0 הנה הנה הנה conjunction unspecified unspecified unspecified unspecified unspecified  	O	null

0 ימים יום ימים noun masculine plural absolute unspecified unspecified  	O	null

0 רבים רב רבים adjective masculine plural absolute unspecified unspecified  	O	null

0 חלפו חלף חלפו verb masculine-and-feminine plural unspecified 3 past  	O	null

0 ו ו ושתי conjunction unspecified unspecified unspecified unspecified unspecified 0 
0 שתי שת ושתי verb masculine-and-feminine singular unspecified 1 past  	O	null

0 ידי יד ידי noun feminine plural construct unspecified unspecified  	O	null

0 עייפו עייף עייפו verb masculine-and-feminine plural unspecified 3 past  	O	null

0 ו ו ועינייך conjunction unspecified unspecified unspecified unspecified unspecified 0 
0 עיני עין ועינייך noun feminine plural absolute unspecified unspecified  
0 ך ך ועינייך possessive feminine singular unspecified 2 unspecified 0 	O	null

0 מה מה מה interrogative unspecified unspecified unspecified unspecified unspecified  	O	null

0 יפו יפו יפו properName unspecified unspecified unspecified unspecified unspecified  	I_LOC	null

0 כ כ כעיני preposition unspecified unspecified unspecified unspecified unspecified 0 
0 עיני עין כעיני noun feminine plural construct unspecified unspecified  	O	null

0 רחל רחל רחל properName feminine singular unspecified unspecified unspecified  	I_PERS	null

0 אני הוא אני pronoun masculine-and-feminine singular unspecified 1 unspecified  	O	null

0 אוהב אהב אוהב verb masculine singular unspecified any beinoni  	O	null

0 את את אותך at-preposition unspecified unspecified unspecified unspecified unspecified  
0 ך ך אותך pronomial masculine singular unspecified 2 unspecified 0 	O	null

0 לאה לאה לאה properName feminine singular unspecified unspecified unspecified  	I_PERS	null

0 אוהב אהב אוהב verb masculine singular unspecified any beinoni  	O	null

0 את את אותך at-preposition unspecified unspecified unspecified unspecified unspecified  
0 ך ך אותך pronomial masculine singular unspecified 2 unspecified 0 	O	null

0 גאה גאה גאה adjective masculine singular absolute unspecified unspecified  	O	null

0 אם אם אם conjunction unspecified unspecified unspecified unspecified unspecified  	O	null

0 אשכח שכח אשכח verb masculine-and-feminine singular unspecified 1 future  	O	null

0 את את אותך at-preposition unspecified unspecified unspecified unspecified unspecified  
0 ך ך אותך pronomial masculine singular unspecified 2 unspecified 0 	O	null

0 לאה לאה לאה properName feminine singular unspecified unspecified unspecified  	I_PERS	null

0 שמי שמי שמי noun masculine singular absolute unspecified unspecified  	O	null

0 לא לא לא negation unspecified unspecified unspecified unspecified unspecified  	O	null

0 ישראל ישראל ישראל properName unspecified unspecified unspecified unspecified unspecified  	I_PERS	null

