0 אנה אנה אנה properName unspecified unspecified unspecified unspecified unspecified  	I_PERS	null

0 מוכשרת מוכשר מוכשרת adjective feminine singular absolute unspecified unspecified  	O	null

0 המון המון המון noun masculine singular absolute unspecified unspecified  	O	null

0 פוטנציאל פוטנציאל פוטנציאל noun masculine singular absolute unspecified unspecified  	O	null

0 פעם פעם פעם noun feminine singular absolute unspecified unspecified  	O	null

0 היא הוא היא pronoun feminine singular unspecified 3 unspecified  	O	null

0 תצליח הצליח תצליח verb feminine singular unspecified 3 future  	O	null

0 אם אם אם conjunction unspecified unspecified unspecified unspecified unspecified  	O	null

0 ירצה רצה ירצה verb masculine singular unspecified 3 future  	O	null

0 ה ה הגורל definiteArticle unspecified unspecified unspecified unspecified unspecified 0 
0 הגורל גורל הגורל noun masculine singular absolute unspecified unspecified  	O	null

0 אנה אנה אנה properName unspecified unspecified unspecified unspecified unspecified  	I_PERS	null

0 לא לא לא negation unspecified unspecified unspecified unspecified unspecified  	O	null

0 גומרת גמר גומרת verb feminine singular unspecified any beinoni  	O	null

0 אנה אנה אנה properName unspecified unspecified unspecified unspecified unspecified  	I_PERS	null

0 מ מ מאחרת preposition unspecified unspecified unspecified unspecified unspecified 0 
0 אחרת אחר מאחרת adjective feminine singular absolute unspecified unspecified  	O	null

0 ל ל למקום preposition unspecified unspecified unspecified unspecified unspecified 0 
0 מקום מקום למקום noun masculine singular absolute unspecified unspecified  	O	null

0 ש ש שאי relativizer/subordinatingConjunction unspecified unspecified unspecified unspecified unspecified 0 
0 אי אי שאי noun masculine singular construct unspecified unspecified  	O	null

0 אפשר אפשר אפשר modal unspecified unspecified unspecified unspecified unspecified  	O	null

0 אחרת אחרת אחרת adverb unspecified unspecified unspecified unspecified unspecified  	O	null

