0 רוקדים רקד רוקדים verb masculine plural unspecified any beinoni  	O	null

0 כאן כאן כאן adverb unspecified unspecified unspecified unspecified unspecified  	O	null

0 על על על preposition unspecified unspecified unspecified unspecified unspecified  	O	null

0 ה ה הקצב definiteArticle unspecified unspecified unspecified unspecified unspecified 0 
0 הקצב קצב הקצב noun masculine singular absolute unspecified unspecified  	O	null

0 ו ו ולא conjunction unspecified unspecified unspecified unspecified unspecified 0 
0 לא לא ולא negation unspecified unspecified unspecified unspecified unspecified  	O	null

0 נעצור עצר נעצור verb masculine-and-feminine plural unspecified 1 future  	O	null

0 מסיק מסיק מסיקה noun masculine singular absolute unspecified unspecified  
0 ה ה מסיקה possessive feminine singular unspecified 3 unspecified 0 	O	null

0 שי שי שי properName unspecified unspecified unspecified unspecified unspecified  	I_PERS	null

0 Do Do Do foreign unspecified unspecified unspecified unspecified unspecified  	I_ORG	null

0 You You You foreign unspecified unspecified unspecified unspecified unspecified  	I_ORG	null

0 Want Want Want foreign unspecified unspecified unspecified unspecified unspecified  	I_ORG	null

0 More More More foreign unspecified unspecified unspecified unspecified unspecified  	I_ORG	null

0 מה מה מה interrogative unspecified unspecified unspecified unspecified unspecified  	O	null

0 ש ש שלא relativizer/subordinatingConjunction unspecified unspecified unspecified unspecified unspecified 0 
0 לא לא שלא negation unspecified unspecified unspecified unspecified unspecified  	O	null

0 יהיה הוא יהיה copula masculine singular unspecified 3 future  	O	null

0 זה זה זה pronoun masculine singular unspecified 3 unspecified  	O	null

0 מסיבת מסיבה מסיבת noun feminine singular construct unspecified unspecified  	O	null

0 ה ה העשור definiteArticle unspecified unspecified unspecified unspecified unspecified 0 
0 העשור עשור העשור noun masculine singular absolute unspecified unspecified  	O	null

0 Just Just Just foreign unspecified unspecified unspecified unspecified unspecified  	I_ORG	null

0 get get get foreign unspecified unspecified unspecified unspecified unspecified  	I_ORG	null

0 your your your foreign unspecified unspecified unspecified unspecified unspecified  	I_ORG	null

0 ass ass ass foreign unspecified unspecified unspecified unspecified unspecified  	I_ORG	null

0 back back back foreign unspecified unspecified unspecified unspecified unspecified  	I_ORG	null

0 on on on foreign unspecified unspecified unspecified unspecified unspecified  	I_ORG	null

0 the the the foreign unspecified unspecified unspecified unspecified unspecified  	I_ORG	null

0 floor floor floor foreign unspecified unspecified unspecified unspecified unspecified  	I_ORG	null

