0 שושנת שושנה שושנת noun feminine singular construct unspecified unspecified  	O	null

0 ספרד ספרד ספרד properName unspecified unspecified unspecified unspecified unspecified  	I_LOC	null

0 יפה יפה יפה adverb unspecified unspecified unspecified unspecified unspecified  	O	null

0 ב ב באדום preposition unspecified unspecified unspecified unspecified unspecified 0 
0 אדום אדום באדום properName masculine singular unspecified unspecified unspecified  	I_LOC	null

0 היא הוא היא pronoun feminine singular unspecified 3 unspecified  	O	null

0 עטופה עטוף עטופה adjective feminine singular absolute unspecified unspecified  	O	null

0 נעלי נעל נעליה noun masculine plural absolute unspecified unspecified  
0 ה ה נעליה possessive feminine singular unspecified 3 unspecified 0 	O	null

0 רוקעות רקע רוקעות participle feminine plural construct any unspecified  	O	null

0 כדי כדי כדי conjunction unspecified unspecified unspecified unspecified unspecified  	O	null

0 ללכוד לכד ללכוד verb unspecified unspecified unspecified unspecified infinitive  	O	null

0 את את אותך at-preposition unspecified unspecified unspecified unspecified unspecified  
0 ך ך אותך pronomial masculine singular unspecified 2 unspecified 0 	O	null

0 שושנת שושנה שושנת noun feminine singular construct unspecified unspecified  	O	null

0 ספרד ספרד ספרד properName unspecified unspecified unspecified unspecified unspecified  	I_LOC	null

0 יפה יפה יפה adverb unspecified unspecified unspecified unspecified unspecified  	O	null

0 מסתובבת הסתובב מסתובבת verb feminine singular unspecified any beinoni  	O	null

0 כמו כמו כמו preposition unspecified unspecified unspecified unspecified unspecified  	O	null

0 סוף סוף סופה noun masculine singular absolute unspecified unspecified  
0 ה ה סופה possessive feminine singular unspecified 3 unspecified 0 	O	null

0 שתי CARD2 שתי numeral feminine dual construct unspecified unspecified  	O	null

0 יד יד ידיה noun feminine plural absolute unspecified unspecified  
0 ה ה ידיה possessive feminine singular unspecified 3 unspecified 0 	O	null

0 נוגעות נגע נוגעות verb feminine plural unspecified any beinoni  	O	null

0 ב ב ברגשות preposition unspecified unspecified unspecified unspecified unspecified 0 
0 רגשות רגש ברגשות noun masculine plural absolute unspecified unspecified  	O	null

0 של של שלך shel-preposition unspecified unspecified unspecified unspecified unspecified  
0 ך ך שלך pronomial masculine singular unspecified 2 unspecified 0 	O	null

