0 שקלים שקל שקלים noun masculine plural absolute unspecified unspecified  	I_LOC	null

0 שקלים שקל שקלים noun masculine plural absolute unspecified unspecified  	I_LOC	null

0 על על עלינו preposition unspecified unspecified unspecified unspecified unspecified  
0 נו נו עלינו pronomial masculine-and-feminine plural unspecified 1 unspecified 0 	O	null

0 נופלים נפל נופלים verb masculine plural unspecified any beinoni  	O	null

0 ו ו ומישהו conjunction unspecified unspecified unspecified unspecified unspecified 0 
0 מישהו מישהו ומישהו noun masculine singular absolute unspecified unspecified  	O	null

0 אחר אחר אחר adjective masculine singular absolute unspecified unspecified  	O	null

0 את את אותם at-preposition unspecified unspecified unspecified unspecified unspecified  
0 הם הם אותם pronomial masculine plural unspecified 3 unspecified 0 	O	null

0 לוקח לקח לוקח verb masculine singular unspecified any beinoni  	O	null

0 אתה הוא אתה pronoun masculine singular unspecified 2 unspecified  	O	null

0 שבוי שבוי שבוי noun masculine singular absolute unspecified unspecified  	O	null

0 ב ב בהבטחות preposition unspecified unspecified unspecified unspecified unspecified 0 
0 הבטחות הבטחה בהבטחות noun feminine plural absolute unspecified unspecified  	O	null

0 בלי בלי בלי preposition unspecified unspecified unspecified unspecified unspecified  	O	null

0 כיסוי כיסוי כיסוי noun masculine singular absolute unspecified unspecified  	O	null

0 לוקח לקח לוקח verb masculine singular unspecified any beinoni  	O	null

0 קשה קשה קשה adverb unspecified unspecified unspecified unspecified unspecified  	O	null

0 את את את at-preposition unspecified unspecified unspecified unspecified unspecified  	O	null

0 ה ה הכל definiteArticle unspecified unspecified unspecified unspecified unspecified 0 
0 הכל כול הכל quantifier unspecified unspecified unspecified unspecified unspecified  	O	null

0 אבל אבל אבל conjunction unspecified unspecified unspecified unspecified unspecified  	O	null

0 ממשיך המשיך ממשיך verb masculine singular unspecified any beinoni  	O	null

0 לחיות חי לחיות verb unspecified unspecified unspecified unspecified infinitive  	O	null

