0 ב ב בנובמבר preposition unspecified unspecified unspecified unspecified unspecified 0 
0 נובמבר נובמבר בנובמבר properName unspecified unspecified unspecified unspecified unspecified  	I_DATE	null

0 ניפרד נפרד ניפרד verb masculine singular unspecified 3 past  	O	null

0 כדי כדי כדי conjunction unspecified unspecified unspecified unspecified unspecified  	O	null

0 לשוב שב לשוב verb unspecified unspecified unspecified unspecified infinitive  	O	null

0 ל ל להתראות preposition unspecified unspecified unspecified unspecified unspecified 0 
0 התראות התראה להתראות noun feminine plural absolute unspecified unspecified  	O	null

0 תבכי בכה תבכי verb feminine singular unspecified 2 future  	O	null

0 מ מ מצחוק preposition unspecified unspecified unspecified unspecified unspecified 0 
0 צחוק צחוק מצחוק noun masculine singular absolute unspecified unspecified  	O	null

0 ו ו ותצחקי conjunction unspecified unspecified unspecified unspecified unspecified 0 
0 תצחקי צחק ותצחקי verb feminine singular unspecified 2 future  	O	null

0 דמעות דמעה דמעות noun feminine plural absolute unspecified unspecified  	O	null

0 בוא בוא בואי noun masculine singular absolute unspecified unspecified  
0 י י בואי possessive masculine-and-feminine singular unspecified 1 unspecified 0 	O	null

0 נתפוס תפס נתפוס verb masculine-and-feminine plural unspecified 1 future  	O	null

0 כוכב כוכב כוכב noun masculine singular construct unspecified unspecified  	O	null

0 נופל נפל נופל verb masculine singular unspecified any beinoni  	O	null

0 ב ב בערב preposition unspecified unspecified unspecified unspecified unspecified 0 
0 ערב ערב בערב noun masculine singular absolute unspecified unspecified  	O	null

0 סתיו סתיו סתיו noun masculine singular absolute unspecified unspecified  	I_DATE	null

0 אפל אפל אפל adjective masculine singular absolute unspecified unspecified  	O	null

