0 ככה ככה ככה adverb unspecified unspecified unspecified unspecified unspecified  	O	null

0 תשמע שמע תשמע verb feminine singular unspecified 3 future  	O	null

0 איך איך איך adverb unspecified unspecified unspecified unspecified unspecified  	O	null

0 לפתע לפתע לפתע adverb unspecified unspecified unspecified unspecified unspecified  	O	null

0 יפתח יפתח יפתח properName unspecified unspecified unspecified unspecified unspecified  	I_PERS	null

0 שער שער שער noun masculine singular construct unspecified unspecified  	O	null

0 ב ב בצלצול preposition unspecified unspecified unspecified unspecified unspecified 0 
0 צלצול צלצול בצלצול noun masculine singular absolute unspecified unspecified  	O	null

0 מוכר מוכר מוכר adjective masculine singular absolute unspecified unspecified  	O	null

0 ככה ככה ככה adverb unspecified unspecified unspecified unspecified unspecified  	O	null

0 תראה ראה תראה verb feminine singular unspecified 3 future  	O	null

0 איך איך איך adverb unspecified unspecified unspecified unspecified unspecified  	O	null

0 מ מ מלילה preposition unspecified unspecified unspecified unspecified unspecified 0 
0 לילה לילה מלילה noun masculine singular absolute unspecified unspecified  	O	null

0 יעלה עלה יעלה verb masculine singular unspecified 3 future  	O	null

0 שחר שחר שחר properName masculine singular unspecified unspecified unspecified  	I_PERS	null

0 ו ו ואיתו conjunction unspecified unspecified unspecified unspecified unspecified 0 
0 את את ואיתו at-preposition unspecified unspecified unspecified unspecified unspecified  
0 ו ו ואיתו pronomial masculine singular unspecified 3 unspecified 0 	O	null

0 מחר מחר מחר adverb unspecified unspecified unspecified unspecified unspecified  	O	null

