0 מזרח מזרח מזרח noun masculine singular construct unspecified unspecified  	O	null

0 תיכון תיכון תיכון noun masculine singular absolute unspecified unspecified  	O	null

0 של של שלי shel-preposition unspecified unspecified unspecified unspecified unspecified  
0 י י שלי pronomial masculine-and-feminine singular unspecified 1 unspecified 0 	O	null

0 יפה יפה יפה adverb unspecified unspecified unspecified unspecified unspecified  	O	null

0 אתה הוא אתה pronoun masculine singular unspecified 2 unspecified  	O	null

0 מ מ מכל preposition unspecified unspecified unspecified unspecified unspecified 0 
0 כל כול מכל quantifier unspecified unspecified construct unspecified unspecified  	O	null

0 בנות בת בנותיך noun feminine plural absolute unspecified unspecified  
0 ך ך בנותיך possessive feminine singular unspecified 2 unspecified 0 	O	null

0 חן חן חן noun masculine singular absolute unspecified unspecified  	O	null

0 נושאות נשא נושאות verb feminine plural unspecified any beinoni  	O	null

0 חופי חוף חופיך noun masculine plural absolute unspecified unspecified  
0 ך ך חופיך possessive feminine singular unspecified 2 unspecified 0 	O	null

0 זהובי זהוב זהובי adjective masculine plural construct unspecified unspecified  	O	null

0 חול חול חול noun masculine singular absolute unspecified unspecified  	O	null

0 מ מ מדבר preposition unspecified unspecified unspecified unspecified unspecified 0 
0 דבר דבר מדבר noun masculine singular absolute unspecified unspecified  	O	null

0 ו ו וים conjunction unspecified unspecified unspecified unspecified unspecified 0 
0 ים ים וים noun masculine singular absolute unspecified unspecified  	O	null

0 נושקים נשק נושקים verb masculine plural unspecified any beinoni  	O	null

0 יאירו האיר יאירו verb masculine-and-feminine plural unspecified 3 future  	O	null

0 שמי שמי שמי noun masculine singular absolute unspecified unspecified  	O	null

0 ה ה התכול definiteArticle unspecified unspecified unspecified unspecified unspecified 0 
0 התכול תכול התכול adjective masculine singular absolute unspecified unspecified  	O	null

0 ו ו והלילות conjunction unspecified unspecified unspecified unspecified unspecified 0 
0 ה ה והלילות definiteArticle unspecified unspecified unspecified unspecified unspecified 0 
0 הלילות לילה והלילות noun masculine plural absolute unspecified unspecified  	O	null

0 יפים יפה יפים adjective masculine plural absolute unspecified unspecified  	O	null

0 לו לו לו conjunction unspecified unspecified unspecified unspecified unspecified  	O	null

0 רק רק רק conjunction unspecified unspecified unspecified unspecified unspecified  	O	null

0 תדע ידע תדע verb feminine singular unspecified 3 future  	O	null

0 אחוות אחווה אחוות noun feminine singular construct unspecified unspecified  	O	null

0 עמים עם עמים noun masculine plural absolute unspecified unspecified  	O	null

0 בני בן בני noun masculine plural construct unspecified unspecified  	O	null

0 אברהם אברהם אברהם properName unspecified unspecified unspecified unspecified unspecified  	I_PERS	null

0 ישכון שכן ישכון verb masculine singular unspecified 3 future  	O	null

0 שלום שלום שלום noun masculine singular construct unspecified unspecified  	O	null

0 ל ל לעד preposition unspecified unspecified unspecified unspecified unspecified 0 
0 עד עד לעד noun masculine singular absolute unspecified unspecified  	O	null

0 ו ו וזמר conjunction unspecified unspecified unspecified unspecified unspecified 0 
0 זמר זמר וזמר noun masculine singular absolute unspecified unspecified  	O	null

0 לא לא לא negation unspecified unspecified unspecified unspecified unspecified  	O	null

0 ייתם ייתם ייתם verb masculine singular unspecified 3 past  	O	null

0 עד עד עד noun masculine singular absolute unspecified unspecified  	O	null

0 בני בן בני noun masculine plural construct unspecified unspecified  	O	null

0 ישראל ישראל ישראל properName unspecified unspecified unspecified unspecified unspecified  	I_PERS	null

0 יניחו הניח יניחו verb masculine-and-feminine plural unspecified 3 future  	O	null

0 את את את at-preposition unspecified unspecified unspecified unspecified unspecified  	O	null

0 נשק נשק נשקם noun masculine singular absolute unspecified unspecified  
0 ם ם נשקם possessive masculine plural unspecified 3 unspecified 0 	O	null

0 יישאו יישאו יישאו verb masculine-and-feminine plural unspecified 3 past  	O	null

0 ברכת בריכה ברכת noun feminine singular construct unspecified unspecified  	O	null

0 ה ה האל definiteArticle unspecified unspecified unspecified unspecified unspecified 0 
0 האל אל האל noun masculine singular absolute unspecified unspecified  	O	null

0 ב ב בשבת preposition unspecified unspecified unspecified unspecified unspecified 0 
0 שבת שבת בשבת properName unspecified unspecified unspecified unspecified unspecified  	I_DATE	null

0 יחד יחד יחד adverb unspecified unspecified unspecified unspecified unspecified  	O	null

0 ב ב במזרח preposition unspecified unspecified unspecified unspecified unspecified 0 
0 ה ה במזרח definiteArticle unspecified unspecified unspecified unspecified unspecified 0 
0 המזרח מזרח במזרח noun masculine singular absolute unspecified unspecified  	O	null

0 של של שלי shel-preposition unspecified unspecified unspecified unspecified unspecified  
0 י י שלי pronomial masculine-and-feminine singular unspecified 1 unspecified 0 	O	null

0 מצרים מצרים מצרים properName unspecified unspecified unspecified unspecified unspecified  	I_LOC	null

0 ו ו וירדן conjunction unspecified unspecified unspecified unspecified unspecified 0 
0 ירדן ירדן וירדן properName unspecified unspecified unspecified unspecified unspecified  	I_LOC	null

0 סוריה סוריה סוריה properName unspecified unspecified unspecified unspecified unspecified  	I_LOC	null

0 אולי אולי אולי adverb unspecified unspecified unspecified unspecified unspecified  	O	null

0 גם גם גם conjunction unspecified unspecified unspecified unspecified unspecified  	O	null

0 כן כן כן conjunction unspecified unspecified unspecified unspecified unspecified  	O	null

0 יחד יחד יחד adverb unspecified unspecified unspecified unspecified unspecified  	O	null

0 ל ל לצד preposition unspecified unspecified unspecified unspecified unspecified 0 
0 ה ה לצד definiteArticle unspecified unspecified unspecified unspecified unspecified 0 
0 הצד צד לצד noun masculine singular absolute unspecified unspecified  	O	null

0 טורקיה טורקיה טורקיה properName unspecified unspecified unspecified unspecified unspecified  	I_LOC	null

0 עירק עיראק עירק properName unspecified unspecified unspecified unspecified unspecified  	I_LOC	null

0 ו ו וסעודיה conjunction unspecified unspecified unspecified unspecified unspecified 0 
0 סעודיה סעודיה וסעודיה properName unspecified unspecified unspecified unspecified unspecified  	I_LOC	null

0 תוניס תוניס תוניס properName unspecified unspecified unspecified unspecified unspecified  	I_LOC	null

0 כווית כווייה כווית noun feminine singular construct unspecified unspecified  	O	null

0 סודן סודן סודן properName unspecified unspecified unspecified unspecified unspecified  	I_LOC	null

0 לבנון לבנון לבנון properName unspecified unspecified unspecified unspecified unspecified  	I_PERS	null

0 אל אל אלג noun masculine singular absolute unspecified unspecified  
0 ה ה אלג possessive feminine singular unspecified 3 unspecified 0 	O	null

0 יר יר יר properName unspecified unspecified unspecified unspecified unspecified  	O	null

0 תימן תימן תימן properName masculine singular unspecified unspecified unspecified  	I_LOC	null

0 מרוקו מרוקו מרוקו properName unspecified unspecified unspecified unspecified unspecified  	I_LOC	null

0 מעבר מעבר מעבר noun masculine singular absolute unspecified unspecified  	O	null

0 ים ים ים noun masculine singular absolute unspecified unspecified  	O	null

0 ו ו וישראל conjunction unspecified unspecified unspecified unspecified unspecified 0 
0 ישראל ישראל וישראל properName unspecified unspecified unspecified unspecified unspecified  	I_LOC	null

0 איתם איתם איתם properName unspecified unspecified unspecified unspecified unspecified  	I_PERS	null

0 ו ו ורק conjunction unspecified unspecified unspecified unspecified unspecified 0 
0 רק רק ורק conjunction unspecified unspecified unspecified unspecified unspecified  	O	null

0 תפילה תפילה תפילה noun feminine singular absolute unspecified unspecified  	O	null

0 זכה זכה זכה verb masculine singular unspecified 3 past  	O	null

0 ל ל לי preposition unspecified unspecified unspecified unspecified unspecified  
0 י י לי pronomial masculine-and-feminine singular unspecified 1 unspecified 0 	O	null

0 נישאת נישא נישאת verb feminine singular unspecified any beinoni  	O	null

0 אל אל אל preposition unspecified unspecified unspecified unspecified unspecified  	O	null

0 ה ה השמיים definiteArticle unspecified unspecified unspecified unspecified unspecified 0 
0 השמיים שמיים השמיים noun masculine plural absolute unspecified unspecified  	O	null

0 ש ש שיהיה relativizer/subordinatingConjunction unspecified unspecified unspecified unspecified unspecified 0 
0 יהיה הוא שיהיה copula masculine singular unspecified 3 future  	O	null

0 כאן כאן כאן adverb unspecified unspecified unspecified unspecified unspecified  	O	null

0 שלום שלום שלום noun masculine singular construct unspecified unspecified  	O	null

0 אמת אמת אמת noun feminine singular absolute unspecified unspecified  	O	null

0 בין בין בין preposition unspecified unspecified unspecified unspecified unspecified  	O	null

0 כל כול כל quantifier unspecified unspecified construct unspecified unspecified  	O	null

0 ה ה העמים definiteArticle unspecified unspecified unspecified unspecified unspecified 0 
0 העמים עם העמים noun masculine plural absolute unspecified unspecified  	O	null

0 היא הוא היא pronoun feminine singular unspecified 3 unspecified  	O	null

0 עולה עלה עולה verb masculine singular unspecified any beinoni  	O	null

0 עם עם עם preposition unspecified unspecified unspecified unspecified unspecified  	O	null

0 קול קול קול noun masculine singular construct unspecified unspecified  	O	null

0 קורא קרא קורא verb masculine singular unspecified any beinoni  	O	null

0 ו ו ושם conjunction unspecified unspecified unspecified unspecified unspecified 0 
0 שם שם ושם adverb unspecified unspecified unspecified unspecified unspecified  	O	null

0 מש מש משטחת temporalSubConj unspecified unspecified unspecified unspecified unspecified 0 
0 טחת טח משטחת participle feminine singular construct any unspecified  	O	null

0 ו ו ונופלת conjunction unspecified unspecified unspecified unspecified unspecified 0 
0 נופלת נפל ונופלת verb feminine singular unspecified any beinoni  	O	null

0 ל ל לרגליו preposition unspecified unspecified unspecified unspecified unspecified 0 
0 רגלי רגל לרגליו noun masculine plural absolute unspecified unspecified  
0 ו ו לרגליו possessive masculine singular unspecified 3 unspecified 0 	O	null

0 של של של shel-preposition unspecified unspecified unspecified unspecified unspecified  	O	null

0 אלוהים אלוהים אלוהים noun masculine singular absolute unspecified unspecified  	O	null

0 מזרח מזרח מזרח noun masculine singular construct unspecified unspecified  	O	null

0 יפה יפה יפה adverb unspecified unspecified unspecified unspecified unspecified  	O	null

0 של של שלי shel-preposition unspecified unspecified unspecified unspecified unspecified  
0 י י שלי pronomial masculine-and-feminine singular unspecified 1 unspecified 0 	O	null

