0 חברון חברון חברון properName unspecified unspecified unspecified unspecified unspecified  	I_PERS	null

0 של של שלי shel-preposition unspecified unspecified unspecified unspecified unspecified  
0 י י שלי pronomial masculine-and-feminine singular unspecified 1 unspecified 0 	O	null

0 חברון חברון חברון properName unspecified unspecified unspecified unspecified unspecified  	I_PERS	null

0 של של של shel-preposition unspecified unspecified unspecified unspecified unspecified  	O	null

0 עם עם עם preposition unspecified unspecified unspecified unspecified unspecified  	O	null

0 יהודי יהודי יהודי noun masculine singular absolute unspecified unspecified  	O	null

0 חברון חברון חברון properName unspecified unspecified unspecified unspecified unspecified  	I_PERS	null

0 עיר עיר עיר noun feminine singular construct unspecified unspecified  	O	null

0 ה ה הקודש definiteArticle unspecified unspecified unspecified unspecified unspecified 0 
0 הקודש קודש הקודש noun masculine singular absolute unspecified unspecified  	O	null

0 ניתנה ניתן ניתנה verb feminine singular unspecified 3 past  	O	null

0 ל ל לעם preposition unspecified unspecified unspecified unspecified unspecified 0 
0 ה ה לעם definiteArticle unspecified unspecified unspecified unspecified unspecified 0 
0 העם עם לעם noun masculine singular absolute unspecified unspecified  	O	null

0 קדוש קדוש קדוש properName unspecified unspecified unspecified unspecified unspecified  	I_PERS	null

0 מאת מאת מאת preposition unspecified unspecified unspecified unspecified unspecified  	O	null

0 ה ה הקדוש definiteArticle unspecified unspecified unspecified unspecified unspecified 0 
0 הקדוש קדוש הקדוש noun masculine singular absolute unspecified unspecified  	O	null

0 ברוך ברוך ברוך properName unspecified unspecified unspecified unspecified unspecified  	I_PERS	null

0 הוא הוא הוא pronoun masculine singular unspecified 3 unspecified  	O	null

