0 ה ה הדואר definiteArticle unspecified unspecified unspecified unspecified unspecified 0 
0 הדואר דואר הדואר noun masculine singular absolute unspecified unspecified  	O	null

0 בא בא בא verb masculine singular unspecified 3 past  	O	null

0 היום היום היום adverb unspecified unspecified unspecified unspecified unspecified  	O	null

0 ב ב באוטו preposition unspecified unspecified unspecified unspecified unspecified 0 
0 ה ה באוטו definiteArticle unspecified unspecified unspecified unspecified unspecified 0 
0 האוטו אוטו באוטו noun masculine singular absolute unspecified unspecified  	O	null

0 ה ה האדום definiteArticle unspecified unspecified unspecified unspecified unspecified 0 
0 האדום אדום האדום adjective masculine singular absolute unspecified unspecified  	I_LOC	null

0 ו ו ולי conjunction unspecified unspecified unspecified unspecified unspecified 0 
0 ל ל ולי preposition unspecified unspecified unspecified unspecified unspecified  
0 י י ולי pronomial masculine-and-feminine singular unspecified 1 unspecified 0 	O	null

0 נתן נתן נתן properName masculine singular unspecified unspecified unspecified  	I_PERS	null

0 מיכתב מיכתב מיכתב adverb unspecified unspecified unspecified unspecified unspecified  	O	null

0 קטן קטן קטן adjective masculine singular absolute unspecified unspecified  	O	null

0 מכתב מכתב מכתב noun masculine singular absolute unspecified unspecified  	O	null

0 עם עם עם preposition unspecified unspecified unspecified unspecified unspecified  	O	null

0 בול בול בול noun masculine singular absolute unspecified unspecified  	O	null

0 אולי אולי אולי adverb unspecified unspecified unspecified unspecified unspecified  	O	null

0 הוא הוא הוא pronoun masculine singular unspecified 3 unspecified  	O	null

0 מ מ מאבי preposition unspecified unspecified unspecified unspecified unspecified 0 
0 אבי אב מאבי properName unspecified unspecified unspecified unspecified unspecified  	I_PERS	null

0 אולי אולי אולי adverb unspecified unspecified unspecified unspecified unspecified  	O	null

0 מ מ מתל preposition unspecified unspecified unspecified unspecified unspecified 0 
0 תל תל מתל noun masculine singular construct unspecified unspecified  	O	null

0 אביב אביב אביב properName unspecified unspecified unspecified unspecified unspecified  	I_PERS	null

0 אולי אולי אולי adverb unspecified unspecified unspecified unspecified unspecified  	O	null

0 ה ה האח definiteArticle unspecified unspecified unspecified unspecified unspecified 0 
0 האח אח האח noun masculine singular absolute unspecified unspecified  	O	null

0 כתב כתב כתב noun masculine singular construct unspecified unspecified  	O	null

0 ל ל לי preposition unspecified unspecified unspecified unspecified unspecified  
0 י י לי pronomial masculine-and-feminine singular unspecified 1 unspecified 0 	O	null

0 כך כך כך adverb unspecified unspecified unspecified unspecified unspecified  	O	null

0 מו מו מו noun masculine singular absolute unspecified unspecified  	O	null

0 ה ה הטיול definiteArticle unspecified unspecified unspecified unspecified unspecified 0 
0 הטיול טיול הטיול noun masculine singular absolute unspecified unspecified  	O	null

0 ה ה הדואר definiteArticle unspecified unspecified unspecified unspecified unspecified 0 
0 הדואר דואר הדואר noun masculine singular absolute unspecified unspecified  	O	null

0 ממהר מיהר ממהר verb masculine singular unspecified any beinoni  	O	null

0 ו ו וטס conjunction unspecified unspecified unspecified unspecified unspecified 0 
0 טס טס וטס verb masculine singular unspecified 3 past  	O	null

0 מן מן מן preposition unspecified unspecified unspecified unspecified unspecified  	O	null

0 ה ה החצר definiteArticle unspecified unspecified unspecified unspecified unspecified 0 
0 החצר חצר החצר noun feminine singular absolute unspecified unspecified  	O	null

0 ל ל לכל preposition unspecified unspecified unspecified unspecified unspecified 0 
0 כל כול לכל quantifier unspecified unspecified construct unspecified unspecified  	O	null

0 מקום מקום מקום noun masculine singular absolute unspecified unspecified  	O	null

0 יבוא ייבוא יבוא noun masculine singular absolute unspecified unspecified  	O	null

0 יום יום יום noun masculine singular absolute unspecified unspecified  	O	null

0 יום יום יום noun masculine singular absolute unspecified unspecified  	O	null

0 שלום שלום שלום noun masculine singular construct unspecified unspecified  	O	null

0 שלום שלום שלום noun masculine singular construct unspecified unspecified  	O	null

