0 אחי אח אחי properName unspecified unspecified unspecified unspecified unspecified  	I_PERS	null

0 אחי אח אחי properName unspecified unspecified unspecified unspecified unspecified  	I_PERS	null

0 ה ה הנתון definiteArticle unspecified unspecified unspecified unspecified unspecified 0 
0 הנתון נתון הנתון noun masculine singular absolute unspecified unspecified  	O	null

0 ב ב בשבייה preposition unspecified unspecified unspecified unspecified unspecified 0 
0 שבייה שבייה בשבייה noun feminine singular absolute unspecified unspecified  	O	null

0 מול מול מול preposition unspecified unspecified unspecified unspecified unspecified  	O	null

0 עיני עין עיני noun feminine plural construct unspecified unspecified  	O	null

0 ב ב בגאון preposition unspecified unspecified unspecified unspecified unspecified 0 
0 גאון גאון בגאון properName unspecified unspecified unspecified unspecified unspecified  	O	null

0 גור גור גור properName unspecified unspecified unspecified unspecified unspecified  	I_PERS	null

0 אריה אריה אריה properName unspecified unspecified unspecified unspecified unspecified  	I_PERS	null

0 יהודה יהודה יהודה properName unspecified unspecified unspecified unspecified unspecified  	I_PERS	null

0 ב ב בכל preposition unspecified unspecified unspecified unspecified unspecified 0 
0 כל כול בכל quantifier unspecified unspecified construct unspecified unspecified  	O	null

0 עתות עת עתותי noun feminine plural absolute unspecified unspecified  
0 י י עתותי possessive masculine-and-feminine singular unspecified 1 unspecified 0 	O	null

0 לך הלך לך verb masculine singular unspecified 2 imperative  	O	null

0 אייחל ייחל אייחל verb masculine-and-feminine singular unspecified 1 future  	O	null

0 על על על preposition unspecified unspecified unspecified unspecified unspecified  	O	null

0 לוח לוח לוח noun masculine singular construct unspecified unspecified  	O	null

0 ליבי ליבי ליבי properName unspecified unspecified unspecified unspecified unspecified  	I_PERS	null

0 ה ה הצבי definiteArticle unspecified unspecified unspecified unspecified unspecified 0 
0 הצבי צבי הצבי noun masculine singular absolute unspecified unspecified  	O	null

0 ישראל ישראל ישראל properName unspecified unspecified unspecified unspecified unspecified  	I_PERS	null

0 בלעדי בלעדי בלעדיך preposition unspecified unspecified unspecified unspecified unspecified  
0 ך ך בלעדיך pronomial masculine singular unspecified 2 unspecified 0 	O	null

0 הווה הווה הווה noun masculine singular absolute unspecified unspecified  	O	null

0 לא לא לא negation unspecified unspecified unspecified unspecified unspecified  	O	null

0 כמו כמו כמו preposition unspecified unspecified unspecified unspecified unspecified  	O	null

0 שהיה שהייה שהיה noun feminine singular absolute unspecified unspecified  	O	null

0 זכור זכור זכור adjective masculine singular absolute unspecified unspecified  	O	null

0 אזכור אזכור אזכור noun masculine singular absolute unspecified unspecified  	O	null

0 את את את at-preposition unspecified unspecified unspecified unspecified unspecified  	O	null

0 ה ה הבן definiteArticle unspecified unspecified unspecified unspecified unspecified 0 
0 הבן בן הבן noun masculine singular absolute unspecified unspecified  	O	null

0 זכריה זכריה זכריה properName unspecified unspecified unspecified unspecified unspecified  	I_PERS	null

0 בעת בעת בעת noun masculine singular construct unspecified unspecified  	O	null

0 ש ש שנשבתה relativizer/subordinatingConjunction unspecified unspecified unspecified unspecified unspecified 0 
0 נשבתה נשבה שנשבתה verb feminine singular unspecified 3 past  	O	null

0 עצר עצר עצר verb masculine singular unspecified 3 past  	O	null

0 ה ה השעון definiteArticle unspecified unspecified unspecified unspecified unspecified 0 
0 השעון שעון השעון noun masculine singular absolute unspecified unspecified  	O	null

0 כש כש כשאשמע temporalSubConj unspecified unspecified unspecified unspecified unspecified 0 
0 אשמע שמע כשאשמע verb masculine-and-feminine singular unspecified 1 future  	O	null

0 צעדי צעד צעדיך noun masculine plural absolute unspecified unspecified  
0 ך ך צעדיך possessive feminine singular unspecified 2 unspecified 0 	O	null

0 יחזור חזר יחזור verb masculine singular unspecified 3 future  	O	null

0 גם גם גם conjunction unspecified unspecified unspecified unspecified unspecified  	O	null

0 רון רון רון properName unspecified unspecified unspecified unspecified unspecified  	I_PERS	null

