0 הייתי הוא הייתי copula masculine-and-feminine singular unspecified 1 past  	O	null

0 רוצה רצה רוצה verb masculine singular unspecified any beinoni  	O	null

0 לטפס טיפס לטפס verb unspecified unspecified unspecified unspecified infinitive  	O	null

0 ל ל לקצה preposition unspecified unspecified unspecified unspecified unspecified 0 
0 קצה קצה לקצה noun masculine singular construct unspecified unspecified  	O	null

0 לבטל ביטל לבטל verb unspecified unspecified unspecified unspecified infinitive  	O	null

0 את את את at-preposition unspecified unspecified unspecified unspecified unspecified  	O	null

0 ה ה הפחד definiteArticle unspecified unspecified unspecified unspecified unspecified 0 
0 הפחד פחד הפחד noun masculine singular absolute unspecified unspecified  	O	null

0 את את את at-preposition unspecified unspecified unspecified unspecified unspecified  	O	null

0 כל כול כל quantifier unspecified unspecified construct unspecified unspecified  	O	null

0 ה ה הצבעים definiteArticle unspecified unspecified unspecified unspecified unspecified 0 
0 הצבעים צבע הצבעים noun masculine plural absolute unspecified unspecified  	O	null

0 מתוך מתוך מתוך preposition unspecified unspecified unspecified unspecified unspecified  	O	null

0 ה ה החיים definiteArticle unspecified unspecified unspecified unspecified unspecified 0 
0 החיים חיים החיים noun masculine plural absolute unspecified unspecified  	O	null

0 ל ל לדעת preposition unspecified unspecified unspecified unspecified unspecified 0 
0 דעת דעה לדעת noun feminine singular construct unspecified unspecified  	O	null

0 לקחת לקח לקחת verb unspecified unspecified unspecified unspecified infinitive  	O	null

0 לפעמים לפעמים לפעמים adverb unspecified unspecified unspecified unspecified unspecified  	O	null

0 את את את at-preposition unspecified unspecified unspecified unspecified unspecified  	O	null

0 הורגת הרג הורגת verb feminine singular unspecified any beinoni  	O	null

0 את את אותי at-preposition unspecified unspecified unspecified unspecified unspecified  
0 י י אותי pronomial masculine-and-feminine singular unspecified 1 unspecified 0 	O	null

0 זה זה זה pronoun masculine singular unspecified 3 unspecified  	O	null

0 אולי אולי אולי adverb unspecified unspecified unspecified unspecified unspecified  	O	null

0 בגלל בגלל בגלל preposition unspecified unspecified unspecified unspecified unspecified  	O	null

0 ש ש שאני relativizer/subordinatingConjunction unspecified unspecified unspecified unspecified unspecified 0 
0 אני הוא שאני pronoun masculine-and-feminine singular unspecified 1 unspecified  	O	null

0 מאוהב מאוהב מאוהב adjective masculine singular absolute unspecified unspecified  	O	null

0 ב ב בך preposition unspecified unspecified unspecified unspecified unspecified  
0 ך ך בך pronomial masculine singular unspecified 2 unspecified 0 	O	null

0 כמעט כמעט כמעט adverb unspecified unspecified unspecified unspecified unspecified  	O	null

0 אבל אבל אבל conjunction unspecified unspecified unspecified unspecified unspecified  	O	null

0 לך הלך לך verb masculine singular unspecified 2 imperative  	O	null

0 לא לא לא negation unspecified unspecified unspecified unspecified unspecified  	O	null

0 אכפת אכפת אכפת adverb unspecified unspecified unspecified unspecified unspecified  	O	null

0 את את את at-preposition unspecified unspecified unspecified unspecified unspecified  	O	null

0 הולכת הולכה הולכת noun feminine singular construct unspecified unspecified  	O	null

0 מן מן ממני preposition unspecified unspecified unspecified unspecified unspecified  
0 י י ממני pronomial masculine-and-feminine singular unspecified 1 unspecified 0 	O	null

0 או או או conjunction unspecified unspecified unspecified unspecified unspecified  	O	null

0 אואו אוורר אואו verb masculine singular unspecified 2 imperative  	O	null

0 לא לא לא negation unspecified unspecified unspecified unspecified unspecified  	O	null

0 לא לא לא negation unspecified unspecified unspecified unspecified unspecified  	O	null

0 את את אתן at-preposition unspecified unspecified unspecified unspecified unspecified  
0 הן הן אתן pronomial feminine plural unspecified 3 unspecified 0 	O	null

0 לך הלך לך verb masculine singular unspecified 2 imperative  	O	null

0 לחמוק חמק לחמוק verb unspecified unspecified unspecified unspecified infinitive  	O	null

0 מ מ מידי preposition unspecified unspecified unspecified unspecified unspecified 0 
0 ידי יד מידי noun feminine plural construct unspecified unspecified  	O	null

0 או או או conjunction unspecified unspecified unspecified unspecified unspecified  	O	null

0 אואו אוורר אואו verb masculine singular unspecified 2 imperative  	O	null

0 ל ל לעולם preposition unspecified unspecified unspecified unspecified unspecified 0 
0 ה ה לעולם definiteArticle unspecified unspecified unspecified unspecified unspecified 0 
0 העולם עולם לעולם noun masculine singular absolute unspecified unspecified  	O	null

0 אל אל אל preposition unspecified unspecified unspecified unspecified unspecified  	O	null

0 תצאי יצא תצאי verb feminine singular unspecified 2 future  	O	null

0 מ מ מחיי preposition unspecified unspecified unspecified unspecified unspecified 0 
0 חיי חיים מחיי noun masculine plural construct unspecified unspecified  	O	null

0 ה ה הבית definiteArticle unspecified unspecified unspecified unspecified unspecified 0 
0 הבית בית הבית noun masculine singular absolute unspecified unspecified  	O	null

0 שותק שתק שותק verb masculine singular unspecified any beinoni  	O	null

0 ו ו והפחד conjunction unspecified unspecified unspecified unspecified unspecified 0 
0 ה ה והפחד definiteArticle unspecified unspecified unspecified unspecified unspecified 0 
0 הפחד פחד והפחד noun masculine singular absolute unspecified unspecified  	O	null

0 חונק חנק חונק verb masculine singular unspecified any beinoni  	O	null

0 לא לא לא negation unspecified unspecified unspecified unspecified unspecified  	O	null

0 יכול יכול יכול modal masculine singular unspecified any beinoni  	O	null

0 בלעדי בלעדי בלעדייך preposition unspecified unspecified unspecified unspecified unspecified  
0 ך ך בלעדייך pronomial feminine singular unspecified 2 unspecified 0 	O	null

0 אפילו אפילו אפילו conjunction unspecified unspecified unspecified unspecified unspecified  	O	null

0 ה ה הלב definiteArticle unspecified unspecified unspecified unspecified unspecified 0 
0 הלב לב הלב noun masculine singular absolute unspecified unspecified  	O	null

0 מודה הודה מודה verb masculine singular unspecified any beinoni  	O	null

0 ו ו ועוזב conjunction unspecified unspecified unspecified unspecified unspecified 0 
0 עוזב עזב ועוזב verb masculine singular unspecified any beinoni  	O	null

0 רוצה רצה רוצה verb masculine singular unspecified any beinoni  	O	null

0 שוב שוב שוב adverb unspecified unspecified unspecified unspecified unspecified  	O	null

0 אליי אל אלייך noun masculine plural absolute unspecified unspecified  
0 ך ך אלייך possessive feminine singular unspecified 2 unspecified 0 	O	null

0 לו לו לו conjunction unspecified unspecified unspecified unspecified unspecified  	O	null

0 היה הוא היה copula masculine singular unspecified 3 past  	O	null

0 ל ל לי preposition unspecified unspecified unspecified unspecified unspecified  
0 י י לי pronomial masculine-and-feminine singular unspecified 1 unspecified 0 	O	null

0 ה ה האומץ definiteArticle unspecified unspecified unspecified unspecified unspecified 0 
0 האומץ אומץ האומץ noun masculine singular absolute unspecified unspecified  	O	null

0 לומר אמר לומר verb unspecified unspecified unspecified unspecified infinitive  	O	null

0 ב ב במשפט preposition unspecified unspecified unspecified unspecified unspecified 0 
0 ה ה במשפט definiteArticle unspecified unspecified unspecified unspecified unspecified 0 
0 המשפט משפט במשפט noun masculine singular absolute unspecified unspecified  	O	null

0 אחד איחד אחד verb masculine singular unspecified 3 past  	O	null

0 ש ש שאני relativizer/subordinatingConjunction unspecified unspecified unspecified unspecified unspecified 0 
0 אני הוא שאני pronoun masculine-and-feminine singular unspecified 1 unspecified  	O	null

0 מאוהב מאוהב מאוהב adjective masculine singular absolute unspecified unspecified  	O	null

0 באמת באמת באמת adverb unspecified unspecified unspecified unspecified unspecified  	O	null

0 ו ו ורוצה conjunction unspecified unspecified unspecified unspecified unspecified 0 
0 רוצה רצה ורוצה verb masculine singular unspecified any beinoni  	O	null

0 לך הלך לך verb masculine singular unspecified 2 imperative  	O	null

0 לתת נתן לתת verb unspecified unspecified unspecified unspecified infinitive  	O	null

0 עוד עוד עוד adverb unspecified unspecified unspecified unspecified unspecified  	O	null

0 חלק חלק חלק noun masculine singular absolute unspecified unspecified  	O	null

0 מן מן ממני preposition unspecified unspecified unspecified unspecified unspecified  
0 י י ממני pronomial masculine-and-feminine singular unspecified 1 unspecified 0 	O	null

0 Dis Dis Dis foreign unspecified unspecified unspecified unspecified unspecified  	I_ORG	null

0 moi moi moi foreign unspecified unspecified unspecified unspecified unspecified  	I_ORG	null

0 est-ce est-ce est-ce foreign unspecified unspecified unspecified unspecified unspecified  	I_ORG	null

0 que que que foreign unspecified unspecified unspecified unspecified unspecified  	I_ORG	null

0 tu tu tu foreign unspecified unspecified unspecified unspecified unspecified  	I_ORG	null

0 m m m foreign unspecified unspecified unspecified unspecified unspecified  	I_ORG	null

0 aime aime aime foreign unspecified unspecified unspecified unspecified unspecified  	I_ORG	null

0 Dis Dis Dis foreign unspecified unspecified unspecified unspecified unspecified  	I_ORG	null

0 moi moi moi foreign unspecified unspecified unspecified unspecified unspecified  	I_ORG	null

0 si si si foreign unspecified unspecified unspecified unspecified unspecified  	I_ORG	null

0 je je je foreign unspecified unspecified unspecified unspecified unspecified  	I_ORG	null

0 te te te foreign unspecified unspecified unspecified unspecified unspecified  	I_ORG	null

0 plais plais plais foreign unspecified unspecified unspecified unspecified unspecified  	I_ORG	null

0 J J J foreign unspecified unspecified unspecified unspecified unspecified  	I_ORG	null

0 ai ai ai foreign unspecified unspecified unspecified unspecified unspecified  	I_ORG	null

0 mon mon mon foreign unspecified unspecified unspecified unspecified unspecified  	I_ORG	null

0 coeur coeur coeur foreign unspecified unspecified unspecified unspecified unspecified  	I_ORG	null

0 qui qui qui foreign unspecified unspecified unspecified unspecified unspecified  	I_ORG	null

0 bats bats bats foreign unspecified unspecified unspecified unspecified unspecified  	I_ORG	null

0 Dis Dis Dis foreign unspecified unspecified unspecified unspecified unspecified  	I_ORG	null

0 moi moi moi foreign unspecified unspecified unspecified unspecified unspecified  	I_ORG	null

0 Alon Alon Alon foreign unspecified unspecified unspecified unspecified unspecified  	I_ORG	null

0 jean jean jean foreign unspecified unspecified unspecified unspecified unspecified  	I_ORG	null

0 dis dis dis foreign unspecified unspecified unspecified unspecified unspecified  	I_ORG	null

0 moi moi moi foreign unspecified unspecified unspecified unspecified unspecified  	I_ORG	null

