0 לא לא לא negation unspecified unspecified unspecified unspecified unspecified  	O	null

0 אשכחך אשכחך אשכחך noun masculine singular absolute unspecified unspecified  	O	null

0 ציון ציון ציון properName unspecified unspecified unspecified unspecified unspecified  	I_PERS	null

0 חמדת חמדה חמדתי noun feminine singular absolute unspecified unspecified  
0 י י חמדתי possessive masculine-and-feminine singular unspecified 1 unspecified 0 	O	null

0 את את את at-preposition unspecified unspecified unspecified unspecified unspecified  	O	null

0 כל כול כל quantifier unspecified unspecified construct unspecified unspecified  	O	null

0 עוד עוד עוד adverb unspecified unspecified unspecified unspecified unspecified  	O	null

0 אחי אח אחי properName unspecified unspecified unspecified unspecified unspecified  	I_PERS	null

0 תוחלת תוחלת תוחלתי noun feminine singular absolute unspecified unspecified  
0 י י תוחלתי possessive masculine-and-feminine singular unspecified 1 unspecified 0 	O	null

0 ו ו ושברי conjunction unspecified unspecified unspecified unspecified unspecified 0 
0 שברי שבר ושברי noun masculine plural construct unspecified unspecified  	O	null

0 ו ו ועת conjunction unspecified unspecified unspecified unspecified unspecified 0 
0 עת עת ועת noun feminine singular absolute unspecified unspecified  	O	null

0 ה ה הכל definiteArticle unspecified unspecified unspecified unspecified unspecified 0 
0 הכל כול הכל quantifier unspecified unspecified unspecified unspecified unspecified  	O	null

0 אשכחה אשכחה אשכחה verb masculine-and-feminine singular unspecified 1 future  	O	null

0 עד עד עד noun masculine singular absolute unspecified unspecified  	O	null

0 שארית שארית שארית noun feminine singular construct unspecified unspecified  	O	null

0 נשמתי נשם נשמתי verb masculine-and-feminine singular unspecified 1 past  	O	null

0 ו ו וציון conjunction unspecified unspecified unspecified unspecified unspecified 0 
0 ציון ציון וציון properName unspecified unspecified unspecified unspecified unspecified  	I_PERS	null

0 את את את at-preposition unspecified unspecified unspecified unspecified unspecified  	O	null

0 ציון ציון ציון properName unspecified unspecified unspecified unspecified unspecified  	I_PERS	null

0 תהי תהה תהי verb feminine singular unspecified 2 imperative  	O	null

0 על על עלי preposition unspecified unspecified unspecified unspecified unspecified  
0 י י עלי pronomial masculine-and-feminine singular unspecified 1 unspecified 0 	O	null

0 קברי קבר קברי noun masculine plural construct unspecified unspecified  	O	null

