0 התבשר התבשר התבשר verb masculine singular unspecified 3 past  	O	null

0 רוע רוע רועה noun masculine singular absolute unspecified unspecified  
0 ה ה רועה possessive feminine singular unspecified 3 unspecified 0 	O	null

0 חביב חביב חביב properName unspecified unspecified unspecified unspecified unspecified  	I_PERS	null

0 הן הן הן conjunction unspecified unspecified unspecified unspecified unspecified  	O	null

0 הגיע הגיע הגיע verb masculine singular unspecified 3 past  	O	null

0 תור תור תור noun masculine singular absolute unspecified unspecified  	O	null

0 אביב אביב אביב properName unspecified unspecified unspecified unspecified unspecified  	I_PERS	null

0 רד ירד רד verb masculine singular unspecified 2 imperative  	O	null

0 מן מן מן preposition unspecified unspecified unspecified unspecified unspecified  	O	null

0 ה ה ההר definiteArticle unspecified unspecified unspecified unspecified unspecified 0 
0 ההר הר ההר noun masculine singular absolute unspecified unspecified  	O	null

0 ל ל לבקעה preposition unspecified unspecified unspecified unspecified unspecified 0 
0 ה ה לבקעה definiteArticle unspecified unspecified unspecified unspecified unspecified 0 
0 הבקעה בקעה לבקעה noun feminine singular absolute unspecified unspecified  	O	null

0 על על על preposition unspecified unspecified unspecified unspecified unspecified  	O	null

0 פני פני פני noun masculine singular absolute unspecified unspecified  	O	null

0 כרים כרים כרים properName unspecified unspecified unspecified unspecified unspecified  	I_PERS	null

0 מרעה מרעה מרעה noun masculine singular absolute unspecified unspecified  	O	null

0 תרחיב הרחיב תרחיב verb feminine singular unspecified 3 future  	O	null

0 יבקע בקע יבקע verb masculine singular unspecified 3 future  	O	null

0 שיר שיר שירך noun masculine singular absolute unspecified unspecified  
0 ך ך שירך possessive feminine singular unspecified 2 unspecified 0 	O	null

0 ב ב בעוז preposition unspecified unspecified unspecified unspecified unspecified 0 
0 עוז עוז בעוז properName unspecified unspecified unspecified unspecified unspecified  	I_PERS	null

0 ירהיב הרהיב ירהיב verb masculine singular unspecified 3 future  	O	null

0 שירת שירה שירת noun feminine singular construct unspecified unspecified  	O	null

0 רועים רועה רועים noun masculine plural absolute unspecified unspecified  	O	null

0 עתיקה עתיקה עתיקה noun feminine singular absolute unspecified unspecified  	O	null

0 רון רון רון properName unspecified unspecified unspecified unspecified unspecified  	I_PERS	null

0 רון רון רונו noun masculine singular absolute unspecified unspecified  
0 ו ו רונו possessive masculine singular unspecified 3 unspecified 0 	O	null

0 עדרים עדר עדרים noun masculine plural absolute unspecified unspecified  	O	null

0 גלושו גלושו גלושו properName unspecified unspecified unspecified unspecified unspecified  	O	null

0 גלושו גלושו גלושו properName unspecified unspecified unspecified unspecified unspecified  	O	null

0 מ מ מהרים preposition unspecified unspecified unspecified unspecified unspecified 0 
0 הרים הר מהרים noun masculine plural absolute unspecified unspecified  	O	null

0 רון רון רון properName unspecified unspecified unspecified unspecified unspecified  	I_PERS	null

0 רון רון רונו noun masculine singular absolute unspecified unspecified  
0 ו ו רונו possessive masculine singular unspecified 3 unspecified 0 	O	null

0 עדרים עדר עדרים noun masculine plural absolute unspecified unspecified  	O	null

0 רון רון רונו noun masculine singular absolute unspecified unspecified  
0 ו ו רונו possessive masculine singular unspecified 3 unspecified 0 	O	null

0 התבשרי התבשרי התבשרי verb feminine singular unspecified 2 future  	O	null

0 כבשה כבשה כבשה noun feminine singular absolute unspecified unspecified  	O	null

0 גם גם גם conjunction unspecified unspecified unspecified unspecified unspecified  	O	null

0 עז עז עז noun feminine singular construct unspecified unspecified  	O	null

0 הן הן הן conjunction unspecified unspecified unspecified unspecified unspecified  	O	null

0 הגיע הגיע הגיע verb masculine singular unspecified 3 past  	O	null

0 תור תור תור noun masculine singular absolute unspecified unspecified  	O	null

0 ה ה הגז definiteArticle unspecified unspecified unspecified unspecified unspecified 0 
0 הגז גז הגז noun masculine singular absolute unspecified unspecified  	O	null

0 - - - punctuation unspecified unspecified unspecified unspecified unspecified  	O	null

0 חג חג חג noun masculine singular construct unspecified unspecified  	O	null

0 ל ל לצאן preposition unspecified unspecified unspecified unspecified unspecified 0 
0 צאן צאן לצאן noun masculine singular absolute unspecified unspecified  	O	null

0 ל ל לרועה preposition unspecified unspecified unspecified unspecified unspecified 0 
0 רוע רוע לרועה noun masculine singular absolute unspecified unspecified  
0 ה ה לרועה possessive feminine singular unspecified 3 unspecified 0 	O	null

0 על על על preposition unspecified unspecified unspecified unspecified unspecified  	O	null

0 פני פני פני noun masculine singular absolute unspecified unspecified  	O	null

0 שדה שדה שדה properName unspecified unspecified unspecified unspecified unspecified  	I_PERS	null

0 הבשיל הבשיל הבשיל verb masculine singular unspecified 3 past  	O	null

0 גרעין גרעין גרעין noun masculine singular absolute unspecified unspecified  	O	null

0 עדר עדר עדר noun masculine singular absolute unspecified unspecified  	O	null

0 ה ה הצאן definiteArticle unspecified unspecified unspecified unspecified unspecified 0 
0 הצאן צאן הצאן noun masculine singular absolute unspecified unspecified  	O	null

0 מבהיק מבהיק מבהיק adjective masculine singular absolute unspecified unspecified  	O	null

0 מלבין הלבין מלבין verb masculine singular unspecified any beinoni  	O	null

0 ה ה האח definiteArticle unspecified unspecified unspecified unspecified unspecified 0 
0 האח אח האח noun masculine singular absolute unspecified unspecified  	O	null

0 מה מה מה interrogative unspecified unspecified unspecified unspecified unspecified  	O	null

0 טוב טוב טוב adverb unspecified unspecified unspecified unspecified unspecified  	O	null

0 ו ו ומה conjunction unspecified unspecified unspecified unspecified unspecified 0 
0 מה מה ומה interrogative unspecified unspecified unspecified unspecified unspecified  	O	null

0 נאה נאה נאה adjective masculine singular absolute unspecified unspecified  	O	null

0 גוז גז גוז verb masculine singular unspecified 2 imperative  	O	null

0 גוזו גז גוזו verb masculine-and-feminine plural unspecified 2 imperative  	O	null

0 גוזזים גזז גוזזים verb masculine plural unspecified any beinoni  	O	null

0 ב ב בן preposition unspecified unspecified unspecified unspecified unspecified  
0 הן הן בן pronomial feminine plural unspecified 3 unspecified 0 	O	null
1 - - - punctuation unspecified unspecified unspecified unspecified unspecified  	O	null
2 כבש כבש כבש noun masculine singular absolute unspecified unspecified  	O	null

0 גדי גדי גדי properName masculine singular unspecified unspecified unspecified  	I_PERS	null

0 עיזים עיזים עיזים noun masculine singular absolute unspecified unspecified  	O	null

0 גוז גז גוז verb masculine singular unspecified 2 imperative  	O	null

0 גוזו גז גוזו verb masculine-and-feminine plural unspecified 2 imperative  	O	null

0 גוזזים גזז גוזזים verb masculine plural unspecified any beinoni  	O	null

0 גוזו גז גוזו verb masculine-and-feminine plural unspecified 2 imperative  	O	null

