0 ב ב בישובי preposition unspecified unspecified unspecified unspecified unspecified 0 
0 ישובי יישובי בישובי adjective masculine singular absolute unspecified unspecified  	O	null

0 ה ה הארץ definiteArticle unspecified unspecified unspecified unspecified unspecified 0 
0 הארץ ארץ הארץ noun feminine singular absolute unspecified unspecified  	O	null

0 ה ה השמועה definiteArticle unspecified unspecified unspecified unspecified unspecified 0 
0 השמועה שמועה השמועה noun feminine singular absolute unspecified unspecified  	O	null

0 פשט פשט פשטה noun masculine singular absolute unspecified unspecified  
0 ה ה פשטה possessive feminine singular unspecified 3 unspecified 0 	O	null

0 ש ש שחללית relativizer/subordinatingConjunction unspecified unspecified unspecified unspecified unspecified 0 
0 חללית חללית שחללית noun feminine singular construct unspecified unspecified  	O	null

0 ב ב בכנסת preposition unspecified unspecified unspecified unspecified unspecified 0 
0 ה ה בכנסת definiteArticle unspecified unspecified unspecified unspecified unspecified 0 
0 הכנסת כנסת בכנסת properName feminine singular unspecified unspecified unspecified  	I_ORG	null

0 נחת נחת נחתה noun masculine singular absolute unspecified unspecified  
0 ה ה נחתה possessive feminine singular unspecified 3 unspecified 0 	O	null

0 ו ו ובתוכה conjunction unspecified unspecified unspecified unspecified unspecified 0 
0 ב ב ובתוכה preposition unspecified unspecified unspecified unspecified unspecified 0 
0 תוך תוך ובתוכה noun masculine singular absolute unspecified unspecified  
0 ה ה ובתוכה possessive feminine singular unspecified 3 unspecified 0 	O	null

0 חייזר חייזר חייזר noun masculine singular construct unspecified unspecified  	O	null

0 נאור נאור נאור properName unspecified unspecified unspecified unspecified unspecified  	I_PERS	null

0 חצי חץ חצי noun masculine plural construct unspecified unspecified  	O	null

0 לבן לבן לבן adjective masculine singular construct unspecified unspecified  	O	null

0 חצי חץ חצי noun masculine plural construct unspecified unspecified  	O	null

0 שחור שחור שחור adjective masculine singular absolute unspecified unspecified  	O	null

0 על על על preposition unspecified unspecified unspecified unspecified unspecified  	O	null

0 ה ה הצבא definiteArticle unspecified unspecified unspecified unspecified unspecified 0 
0 הצבא צבא הצבא noun masculine singular absolute unspecified unspecified  	O	null

0 לקח לקח לקח noun masculine singular absolute unspecified unspecified  	O	null

0 את את את at-preposition unspecified unspecified unspecified unspecified unspecified  	O	null

0 ה ה השליטה definiteArticle unspecified unspecified unspecified unspecified unspecified 0 
0 השליטה שליטה השליטה noun feminine singular absolute unspecified unspecified  	O	null

0 welcome welcome welcome foreign unspecified unspecified unspecified unspecified unspecified  	I_ORG	null

0 to to to foreign unspecified unspecified unspecified unspecified unspecified  	I_ORG	null

0 israel israel israel foreign unspecified unspecified unspecified unspecified unspecified  	I_ORG	null

0 מאה ORD-CARD100 מאה numeral feminine plural absolute unspecified unspecified  	O	null

0 ו ו ועשרים conjunction unspecified unspecified unspecified unspecified unspecified 0 
0 עשרים ORD-CARD20 ועשרים numeral masculine-and-feminine plural construct unspecified unspecified  	O	null

0 חייזרים חייזר חייזרים noun masculine plural absolute unspecified unspecified  	O	null

0 פצצות פצצה פצצות noun feminine plural absolute unspecified unspecified  	O	null

0 אטום אטום אטום noun masculine singular absolute unspecified unspecified  	O	null

0 ו ו ואלף conjunction unspecified unspecified unspecified unspecified unspecified 0 
0 אלף ORD-CARD1000 ואלף numeral masculine plural absolute unspecified unspecified  	O	null

0 שרירים שריר שרירים noun masculine plural absolute unspecified unspecified  	O	null

0 ו ו וגם conjunction unspecified unspecified unspecified unspecified unspecified 0 
0 גם גם וגם conjunction unspecified unspecified unspecified unspecified unspecified  	O	null

0 פועלים פועל פועלים noun masculine plural absolute unspecified unspecified  	O	null

0 זרים זר זרים adjective masculine plural absolute unspecified unspecified  	O	null

0 welcome welcome welcome foreign unspecified unspecified unspecified unspecified unspecified  	I_ORG	null

0 to to to foreign unspecified unspecified unspecified unspecified unspecified  	I_ORG	null

0 israel israel israel foreign unspecified unspecified unspecified unspecified unspecified  	I_ORG	null

0 ה ה הימין definiteArticle unspecified unspecified unspecified unspecified unspecified 0 
0 הימין ימין הימין noun masculine singular absolute unspecified unspecified  	O	null

0 שונא שונא שונא noun masculine singular construct unspecified unspecified  	O	null

0 את את את at-preposition unspecified unspecified unspecified unspecified unspecified  	O	null

0 ה ה השמאל definiteArticle unspecified unspecified unspecified unspecified unspecified 0 
0 השמאל שמאל השמאל noun masculine singular absolute unspecified unspecified  	O	null

0 ה ה הכל definiteArticle unspecified unspecified unspecified unspecified unspecified 0 
0 הכל כול הכל quantifier unspecified unspecified unspecified unspecified unspecified  	O	null

0 עניין עניין עניין noun masculine singular absolute unspecified unspecified  	O	null

0 של של של shel-preposition unspecified unspecified unspecified unspecified unspecified  	O	null

0 כסף כסף כסף noun masculine singular absolute unspecified unspecified  	O	null

0 גדול גדול גדול adjective masculine singular absolute unspecified unspecified  	O	null

0 ו ו ולנו conjunction unspecified unspecified unspecified unspecified unspecified 0 
0 לנו לן ולנו verb masculine-and-feminine plural unspecified 1 past  	O	null

0 אסור אסור אסור adverb unspecified unspecified unspecified unspecified unspecified  	O	null

0 לשאול שאל לשאול verb unspecified unspecified unspecified unspecified infinitive  	O	null

0 ו ו והחייזר conjunction unspecified unspecified unspecified unspecified unspecified 0 
0 ה ה והחייזר definiteArticle unspecified unspecified unspecified unspecified unspecified 0 
0 החייזר חייזר והחייזר noun masculine singular absolute unspecified unspecified  	O	null

0 את את אותנו at-preposition unspecified unspecified unspecified unspecified unspecified  
0 נו נו אותנו pronomial masculine-and-feminine plural unspecified 1 unspecified 0 	O	null

0 לא לא לא negation unspecified unspecified unspecified unspecified unspecified  	O	null

0 מבין הבין מבין verb masculine singular unspecified any beinoni  	O	null

0 על על על preposition unspecified unspecified unspecified unspecified unspecified  	O	null

0 מה מה מה interrogative unspecified unspecified unspecified unspecified unspecified  	O	null

0 ו ו ולמה conjunction unspecified unspecified unspecified unspecified unspecified 0 
0 למה לאמה ולמה noun feminine singular absolute unspecified unspecified  	O	null

0 כאן כאן כאן adverb unspecified unspecified unspecified unspecified unspecified  	O	null

0 כולם כולם כולם pronoun masculine plural unspecified 3 unspecified  	O	null

0 רבים רב רבים adjective masculine plural absolute unspecified unspecified  	O	null

0 יש יש יש existential unspecified unspecified unspecified unspecified unspecified  	O	null

0 דרך דרך דרך noun feminine singular construct unspecified unspecified  	O	null

0 ל ל לשלום preposition unspecified unspecified unspecified unspecified unspecified 0 
0 שלום שלום לשלום noun masculine singular absolute unspecified unspecified  	O	null

0 עכשיו עכשיו עכשיו adverb unspecified unspecified unspecified unspecified unspecified  	O	null

0 אפשר אפשר אפשר modal unspecified unspecified unspecified unspecified unspecified  	O	null

0 לחיות חי לחיות verb unspecified unspecified unspecified unspecified infinitive  	O	null

0 על על על preposition unspecified unspecified unspecified unspecified unspecified  	O	null

0 ה ה הכוכב definiteArticle unspecified unspecified unspecified unspecified unspecified 0 
0 הכוכב כוכב הכוכב noun masculine singular absolute unspecified unspecified  	O	null

0 אסור אסור אסור adverb unspecified unspecified unspecified unspecified unspecified  	O	null

0 לתת נתן לתת verb unspecified unspecified unspecified unspecified infinitive  	O	null

0 ל ל לדת preposition unspecified unspecified unspecified unspecified unspecified 0 
0 דת דת לדת noun feminine singular absolute unspecified unspecified  	O	null

0 את את את at-preposition unspecified unspecified unspecified unspecified unspecified  	O	null

0 ה ה הרובים definiteArticle unspecified unspecified unspecified unspecified unspecified 0 
0 הרובים רובה הרובים noun masculine plural absolute unspecified unspecified  	O	null

0 welcome welcome welcome foreign unspecified unspecified unspecified unspecified unspecified  	I_ORG	null

0 to to to foreign unspecified unspecified unspecified unspecified unspecified  	I_ORG	null

0 israel israel israel foreign unspecified unspecified unspecified unspecified unspecified  	I_ORG	null

