0 מ מ מאיפה preposition unspecified unspecified unspecified unspecified unspecified 0 
0 איפה איפה מאיפה noun feminine singular absolute unspecified unspecified  	O	null

0 מגיעים הגיע מגיעים verb masculine plural unspecified any beinoni  	O	null

0 ה ה השקלים definiteArticle unspecified unspecified unspecified unspecified unspecified 0 
0 השקלים שקל השקלים noun masculine plural absolute unspecified unspecified  	I_LOC	null

0 ב ב בשם preposition unspecified unspecified unspecified unspecified unspecified 0 
0 שם שם בשם noun masculine singular construct unspecified unspecified  	O	null

0 אלוהים אלוהים אלוהים noun masculine singular absolute unspecified unspecified  	O	null

0 אני הוא אני pronoun masculine-and-feminine singular unspecified 1 unspecified  	O	null

0 תפרן תפרן תפרן adjective masculine singular absolute unspecified unspecified  	O	null

0 לנצח לנצח לנצח adverb unspecified unspecified unspecified unspecified unspecified  	O	null

0 איפה איפה איפה noun feminine singular absolute unspecified unspecified  	O	null

0 כל כול כל quantifier unspecified unspecified construct unspecified unspecified  	O	null

0 את את אותם at-preposition unspecified unspecified unspecified unspecified unspecified  
0 הם הם אותם pronomial masculine plural unspecified 3 unspecified 0 	O	null

0 ה ה השקלים definiteArticle unspecified unspecified unspecified unspecified unspecified 0 
0 השקלים שקל השקלים noun masculine plural absolute unspecified unspecified  	I_LOC	null

0 ל ל למי preposition unspecified unspecified unspecified unspecified unspecified 0 
0 מי מי למי interrogative unspecified unspecified unspecified unspecified unspecified  	O	null

0 הם הוא הם pronoun masculine plural unspecified 3 unspecified  	O	null

0 הולכים הלך הולכים verb masculine plural unspecified any beinoni  	O	null

0 מפוזרים פוזר מפוזרים verb masculine plural unspecified any beinoni  	O	null

0 ב ב בשטח preposition unspecified unspecified unspecified unspecified unspecified 0 
0 שטח שטח בשטח noun masculine singular absolute unspecified unspecified  	O	null

