0 כל כול כל quantifier unspecified unspecified construct unspecified unspecified  	O	null

0 שבת שבת שבת properName unspecified unspecified unspecified unspecified unspecified  	I_PERS	null

0 חוגגים חגג חוגגים verb masculine plural unspecified any beinoni  	O	null

0 על על על preposition unspecified unspecified unspecified unspecified unspecified  	O	null

0 ה ה המגרש definiteArticle unspecified unspecified unspecified unspecified unspecified 0 
0 המגרש מגרש המגרש noun masculine singular absolute unspecified unspecified  	O	null

0 כל כול כל quantifier unspecified unspecified construct unspecified unspecified  	O	null

0 משחק משחק משחק noun masculine singular absolute unspecified unspecified  	O	null

0 זה זה זה pronoun masculine singular unspecified 3 unspecified  	O	null

0 קורה קרה קורה verb masculine singular unspecified any beinoni  	O	null

0 שוב שוב שוב adverb unspecified unspecified unspecified unspecified unspecified  	O	null

0 מחדש מחדש מחדש adverb unspecified unspecified unspecified unspecified unspecified  	O	null

0 כש כש כשהם temporalSubConj unspecified unspecified unspecified unspecified unspecified 0 
0 הם הוא כשהם pronoun masculine plural unspecified 3 unspecified  	O	null

0 עולים עולה עולים noun masculine plural absolute unspecified unspecified  	O	null

0 ה ה הקהל definiteArticle unspecified unspecified unspecified unspecified unspecified 0 
0 הקהל קהל הקהל noun masculine singular absolute unspecified unspecified  	O	null

0 צועק צעק צועק verb masculine singular unspecified any beinoni  	O	null

0 סביב סביב סביב preposition unspecified unspecified unspecified unspecified unspecified  	O	null

0 זאת זאת זאת pronoun feminine singular unspecified 3 unspecified  	O	null

0 מכבי מכבי מכבי properName unspecified unspecified unspecified unspecified unspecified  	I_PERS	null

0 תל תל תל properName unspecified unspecified unspecified unspecified unspecified  	O	null

0 אביב אביב אביב properName unspecified unspecified unspecified unspecified unspecified  	I_PERS	null

0 אל אל אל preposition unspecified unspecified unspecified unspecified unspecified  	O	null

0 ה ה השער definiteArticle unspecified unspecified unspecified unspecified unspecified 0 
0 השער שער השער noun masculine singular absolute unspecified unspecified  	O	null

0 נכנס נכנס נכנס verb masculine singular unspecified 3 past  	O	null

0 כדור כדור כדור noun masculine singular absolute unspecified unspecified  	O	null

0 עגול עגול עגול adjective masculine singular absolute unspecified unspecified  	O	null

0 ה ה הצהוב definiteArticle unspecified unspecified unspecified unspecified unspecified 0 
0 הצהוב צהוב הצהוב adjective masculine singular absolute unspecified unspecified  	O	null

0 מתקדם מתקדם מתקדם adjective masculine singular absolute unspecified unspecified  	O	null

0 עם עם עם preposition unspecified unspecified unspecified unspecified unspecified  	O	null

0 ה ה הכחול definiteArticle unspecified unspecified unspecified unspecified unspecified 0 
0 הכחול כחול הכחול adjective masculine singular absolute unspecified unspecified  	O	null

0 כל כול כל quantifier unspecified unspecified construct unspecified unspecified  	O	null

0 בעיטה בעיטה בעיטה noun feminine singular absolute unspecified unspecified  	O	null

0 נגיחה נגיחה נגיחה noun feminine singular absolute unspecified unspecified  	O	null

0 או או או conjunction unspecified unspecified unspecified unspecified unspecified  	O	null

0 ה ה הרמה definiteArticle unspecified unspecified unspecified unspecified unspecified 0 
0 הרמה רמה הרמה noun feminine singular absolute unspecified unspecified  	O	null

0 הם הוא הם pronoun masculine plural unspecified 3 unspecified  	O	null

0 נותנים נתן נותנים verb masculine plural unspecified any beinoni  	O	null

0 את את את at-preposition unspecified unspecified unspecified unspecified unspecified  	O	null

0 ה ה הנשמה definiteArticle unspecified unspecified unspecified unspecified unspecified 0 
0 הנשמה נשמה הנשמה noun feminine singular absolute unspecified unspecified  	O	null

0 ב ב בימים preposition unspecified unspecified unspecified unspecified unspecified 0 
0 ימים יום בימים noun masculine plural absolute unspecified unspecified  	O	null

0 ש ש שקשה relativizer/subordinatingConjunction unspecified unspecified unspecified unspecified unspecified 0 
0 קשה קשה שקשה adverb unspecified unspecified unspecified unspecified unspecified  	O	null

0 ל ל להם preposition unspecified unspecified unspecified unspecified unspecified  
0 הם הם להם pronomial masculine plural unspecified 3 unspecified 0 	O	null

0 יותר יותר יותר adverb unspecified unspecified unspecified unspecified unspecified  	O	null

0 הם הוא הם pronoun masculine plural unspecified 3 unspecified  	O	null

0 יודעים ידע יודעים verb masculine plural unspecified any beinoni  	O	null

0 ש ש שאסור relativizer/subordinatingConjunction unspecified unspecified unspecified unspecified unspecified 0 
0 אסור אסור שאסור modal unspecified unspecified unspecified unspecified unspecified  	O	null

0 פה פה פה adverb unspecified unspecified unspecified unspecified unspecified  	O	null

0 לותר ויתר לותר verb unspecified unspecified unspecified unspecified infinitive  	O	null

0 כל כול כל quantifier unspecified unspecified construct unspecified unspecified  	O	null

0 שחקן שחקן שחקן noun masculine singular absolute unspecified unspecified  	O	null

0 יש יש יש existential unspecified unspecified unspecified unspecified unspecified  	O	null

0 לו לו לו conjunction unspecified unspecified unspecified unspecified unspecified  	O	null

0 אופי אופי אופי noun masculine singular absolute unspecified unspecified  	O	null

0 ו ו ורצון conjunction unspecified unspecified unspecified unspecified unspecified 0 
0 רצון רצון ורצון noun masculine singular absolute unspecified unspecified  	O	null

0 ל ל לההיות preposition unspecified unspecified unspecified unspecified unspecified 0 
0 ה ה לההיות definiteArticle unspecified unspecified unspecified unspecified unspecified 0 
0 הההיות היות לההיות noun masculine singular absolute unspecified unspecified  	O	null

0 תמיד תמיד תמיד adverb unspecified unspecified unspecified unspecified unspecified  	O	null

0 ראשון ORD1 ראשון numeral masculine singular absolute unspecified unspecified  	O	null

0 ב ב בכל preposition unspecified unspecified unspecified unspecified unspecified 0 
0 כל כול בכל quantifier unspecified unspecified construct unspecified unspecified  	O	null

0 מצב מצב מצב noun masculine singular absolute unspecified unspecified  	O	null

0 נעודד עודד נעודד verb masculine-and-feminine plural unspecified 1 future  	O	null

0 את את אותכם at-preposition unspecified unspecified unspecified unspecified unspecified  
0 הם הם אותכם pronomial masculine plural unspecified 3 unspecified 0 	O	null

0 חזר חזר חזר verb masculine singular unspecified 3 past  	O	null

0 תמיד תמיד תמיד adverb unspecified unspecified unspecified unspecified unspecified  	O	null

0 את את איתכם at-preposition unspecified unspecified unspecified unspecified unspecified  
0 כם כם איתכם pronomial masculine plural unspecified 2 unspecified 0 	O	null

0 ל ל לכל preposition unspecified unspecified unspecified unspecified unspecified 0 
0 כל כול לכל quantifier unspecified unspecified construct unspecified unspecified  	O	null

0 אורך אורך אורך noun masculine singular construct unspecified unspecified  	O	null

0 ה ה המשחק definiteArticle unspecified unspecified unspecified unspecified unspecified 0 
0 המשחק משחק המשחק noun masculine singular absolute unspecified unspecified  	O	null

0 צהוב צהוב צהוב adjective masculine singular absolute unspecified unspecified  	O	null

0 כחול כחול כחול adjective masculine singular absolute unspecified unspecified  	O	null

0 זה זה זה pronoun masculine singular unspecified 3 unspecified  	O	null

0 ה ה הצבע definiteArticle unspecified unspecified unspecified unspecified unspecified 0 
0 הצבע צבע הצבע noun masculine singular absolute unspecified unspecified  	O	null

0 ה ה המדליק definiteArticle unspecified unspecified unspecified unspecified unspecified 0 
0 המדליק מדליק המדליק adjective masculine singular absolute unspecified unspecified  	O	null

0 של של של shel-preposition unspecified unspecified unspecified unspecified unspecified  	O	null

0 מכבי מכבי מכבי properName unspecified unspecified unspecified unspecified unspecified  	I_PERS	null

0 תל תל תל properName unspecified unspecified unspecified unspecified unspecified  	O	null

0 אביב אביב אביב properName unspecified unspecified unspecified unspecified unspecified  	I_PERS	null

0 אלכסנדר אלכסנדר אלכסנדר properName unspecified unspecified unspecified unspecified unspecified  	I_PERS	null

0 אוברוב אוברוב אוברוב properName masculine singular unspecified unspecified unspecified  	O	null

0 אמיר אמיר אמיר properName unspecified unspecified unspecified unspecified unspecified  	I_PERS	null

0 שלח שלח שלח verb masculine singular unspecified 3 past  	O	null

0 גדי גדי גדי properName masculine singular unspecified unspecified unspecified  	I_PERS	null

0 ברומר ברומר ברומר properName unspecified unspecified unspecified unspecified unspecified  	O	null

0 אלון אלון אלון properName unspecified unspecified unspecified unspecified unspecified  	I_PERS	null

0 ברומר ברומר ברומר properName unspecified unspecified unspecified unspecified unspecified  	O	null

0 ניר ניר ניר properName unspecified unspecified unspecified unspecified unspecified  	I_PERS	null

0 קלינגר קלינגר קלינגר properName unspecified unspecified unspecified unspecified unspecified  	I_PERS	null

0 נוהם נהם נוהם verb masculine singular unspecified any beinoni  	O	null

0 שוה שהה שוהם participle masculine singular unspecified any unspecified  
0 ם ם שוהם possessive masculine plural unspecified 3 unspecified 0 	O	null

0 יעקוב יעקוב יעקוב properName unspecified unspecified unspecified unspecified unspecified  	I_PERS	null

0 הילל הילל הילל verb masculine singular unspecified 3 past  	O	null

0 רון רון רון properName unspecified unspecified unspecified unspecified unspecified  	I_PERS	null

0 נחמן נחמן נחמן properName unspecified unspecified unspecified unspecified unspecified  	I_PERS	null

0 גיא גיא גיא properName unspecified unspecified unspecified unspecified unspecified  	I_PERS	null

0 נחמן נחמן נחמן properName unspecified unspecified unspecified unspecified unspecified  	I_PERS	null

0 איציק איציק איציק properName unspecified unspecified unspecified unspecified unspecified  	I_PERS	null

0 זוהר זוהר זוהר properName unspecified unspecified unspecified unspecified unspecified  	I_PERS	null

0 אבי אבי אבי properName unspecified unspecified unspecified unspecified unspecified  	I_PERS	null

0 נימני נימני נימני properName unspecified unspecified unspecified unspecified unspecified  	I_PERS	null

0 ויקטור ויקטור ויקטור properName unspecified unspecified unspecified unspecified unspecified  	I_PERS	null

0 מ מ מורוז preposition unspecified unspecified unspecified unspecified unspecified 0 
0 ורוז ורוז מורוז noun masculine singular absolute unspecified unspecified  	O	null

0 חיים חיים חיים noun masculine plural absolute unspecified unspecified  	O	null

0 חג חג חג noun masculine singular construct unspecified unspecified  	O	null

0 ג ג ג properName unspecified unspecified unspecified unspecified unspecified  	O	null

0 אלי אל אלי noun masculine plural construct unspecified unspecified  	O	null

0 דריקס דריקס דריקס properName unspecified unspecified unspecified unspecified unspecified  	I_PERS	null

0 יב יב יבג noun masculine singular absolute unspecified unspecified  
0 ה ה יבג possessive feminine singular unspecified 3 unspecified 0 	O	null

0 ני ני ני noun masculine singular construct unspecified unspecified  	O	null

0 קשנץ קשנץ קשנצ properName unspecified unspecified unspecified unspecified unspecified  	O	null

0 ב ב ב preposition unspecified unspecified unspecified unspecified unspecified  	O	null

0 מאיר מאיר מאיר properName unspecified unspecified unspecified unspecified unspecified  	I_PERS	null

0 מליקה מליקה מליקה noun feminine singular absolute unspecified unspecified  	O	null

0 גל גל גל noun masculine singular construct unspecified unspecified  	O	null

0 פיבך פיבך פיבך properName unspecified unspecified unspecified unspecified unspecified  	O	null

0 בן בן בן properName unspecified unspecified unspecified unspecified unspecified  	I_PERS	null

0 לוז לוז לוז noun masculine singular absolute unspecified unspecified  	O	null

0 עמית עמית עמית noun feminine singular construct unspecified unspecified  	O	null

0 לוי לוי לוי properName unspecified unspecified unspecified unspecified unspecified  	I_PERS	null

0 אלן אלן אלן properName unspecified unspecified unspecified unspecified unspecified  	I_PERS	null

0 מ מ משרקי preposition unspecified unspecified unspecified unspecified unspecified 0 
0 שרקי שרקיה משרקי noun feminine plural construct unspecified unspecified  	O	null

0 דרור דרור דרור properName masculine singular unspecified unspecified unspecified  	I_PERS	null

0 קשטן קשטן קשטן properName unspecified unspecified unspecified unspecified unspecified  	I_PERS	null

