0 שיער שיער שיער noun masculine singular absolute unspecified unspecified  	O	null

0 אדום אדום אדום properName masculine singular unspecified unspecified unspecified  	I_LOC	null

0 כמו כמו כמו preposition unspecified unspecified unspecified unspecified unspecified  	O	null

0 ה ה השמש definiteArticle unspecified unspecified unspecified unspecified unspecified 0 
0 השמש שמש השמש noun feminine singular absolute unspecified unspecified  	O	null

0 ו ו ופרחים conjunction unspecified unspecified unspecified unspecified unspecified 0 
0 פרחים פרח ופרחים noun masculine plural absolute unspecified unspecified  	O	null

0 אדומים אדום אדומים adjective masculine plural absolute unspecified unspecified  	O	null

0 ב ב בידה preposition unspecified unspecified unspecified unspecified unspecified 0 
0 יד יד בידה noun feminine singular absolute unspecified unspecified  
0 ה ה בידה possessive feminine singular unspecified 3 unspecified 0 	O	null

0 גלי גל גלי noun masculine plural construct unspecified unspecified  	O	null

0 את את את at-preposition unspecified unspecified unspecified unspecified unspecified  	O	null

0 מי מי מי interrogative unspecified unspecified unspecified unspecified unspecified  	O	null

0 את את את at-preposition unspecified unspecified unspecified unspecified unspecified  	O	null

0 באמת באמת באמת adverb unspecified unspecified unspecified unspecified unspecified  	O	null

0 אוהבת אהב אוהבת verb feminine singular unspecified any beinoni  	O	null

0 ב ב ברחובותיה preposition unspecified unspecified unspecified unspecified unspecified 0 
0 רחובותי רחוב ברחובותיה noun masculine plural absolute unspecified unspecified  
0 ה ה ברחובותיה possessive feminine singular unspecified 3 unspecified 0 	O	null

0 של של של shel-preposition unspecified unspecified unspecified unspecified unspecified  	O	null

0 הרצליה הרצליה הרצליה properName unspecified unspecified unspecified unspecified unspecified  	I_LOC	null

