0 אני הוא אני pronoun masculine-and-feminine singular unspecified 1 unspecified  	O	null

0 שב שב שב verb masculine singular unspecified 3 past  	O	null

0 אליי אל אלייך noun masculine plural absolute unspecified unspecified  
0 ך ך אלייך possessive feminine singular unspecified 2 unspecified 0 	O	null

0 שב שב שב verb masculine singular unspecified 3 past  	O	null

0 מ מ מאהבה preposition unspecified unspecified unspecified unspecified unspecified 0 
0 אהבה אהבה מאהבה noun feminine singular absolute unspecified unspecified  	O	null

0 ו ו ומגדלור conjunction unspecified unspecified unspecified unspecified unspecified 0 
0 מגדלור מגדלור ומגדלור noun masculine singular absolute unspecified unspecified  	O	null

0 מאיר מאיר מאיר properName unspecified unspecified unspecified unspecified unspecified  	I_PERS	null

0 דרכי דרך דרכי noun feminine plural construct unspecified unspecified  	O	null

0 חזרה חזרה חזרה noun feminine singular absolute unspecified unspecified  	O	null

0 שב שב שב verb masculine singular unspecified 3 past  	O	null

0 אליי אל אלייך noun masculine plural absolute unspecified unspecified  
0 ך ך אלייך possessive feminine singular unspecified 2 unspecified 0 	O	null

0 אל אל אל preposition unspecified unspecified unspecified unspecified unspecified  	O	null

0 ה ה האהבה definiteArticle unspecified unspecified unspecified unspecified unspecified 0 
0 האהבה אהבה האהבה noun feminine singular absolute unspecified unspecified  	O	null

0 וכולי וכולי וכולי adverb unspecified unspecified unspecified unspecified unspecified  	O	null

0 אחוז אחוז אחוז noun masculine singular absolute unspecified unspecified  	I_PERCENT	null

0 ב ב באותה preposition unspecified unspecified unspecified unspecified unspecified 0 
0 אותו אותו באותה quantifier unspecified unspecified unspecified unspecified unspecified  
0 ה ה באותה pronomial feminine singular unspecified 3 unspecified 0 	O	null

0 תקווה תקווה תקווה noun feminine singular absolute unspecified unspecified  	O	null

