0 בתוך בתוך בתוך preposition unspecified unspecified unspecified unspecified unspecified  	O	null

0 ענן ענן ענן noun masculine singular absolute unspecified unspecified  	O	null

0 ענן ענן ענן noun masculine singular absolute unspecified unspecified  	O	null

0 לבן לבן לבן adjective masculine singular construct unspecified unspecified  	O	null

0 ירושלים ירושלים ירושלים properName unspecified unspecified unspecified unspecified unspecified  	I_LOC	null

0 שוכנת שכן שוכנת verb feminine singular unspecified any beinoni  	O	null

0 על על על preposition unspecified unspecified unspecified unspecified unspecified  	O	null

0 ו ו ואני conjunction unspecified unspecified unspecified unspecified unspecified 0 
0 אני הוא ואני pronoun masculine-and-feminine singular unspecified 1 unspecified  	O	null

0 מטייל מטייל מטייל noun masculine singular absolute unspecified unspecified  	O	null

0 בשמיים בשמיים בשמיים adverb unspecified unspecified unspecified unspecified unspecified  	O	null

0 בתוך בתוך בתוך preposition unspecified unspecified unspecified unspecified unspecified  	O	null

0 ה ה הגן definiteArticle unspecified unspecified unspecified unspecified unspecified 0 
0 הגן גן הגן noun masculine singular absolute unspecified unspecified  	O	null

0 ב ב בעדן preposition unspecified unspecified unspecified unspecified unspecified 0 
0 עדן עדן בעדן noun masculine singular absolute unspecified unspecified  	O	null

0 גן גן גן noun masculine singular absolute unspecified unspecified  	O	null

0 ירושלים ירושלים ירושלים properName unspecified unspecified unspecified unspecified unspecified  	I_LOC	null

0 זהב זהב זהב noun masculine singular absolute unspecified unspecified  	O	null

0 קלל קילל קלל verb masculine singular unspecified 3 past  	O	null

0 מצועפת צועף מצועפת participle feminine singular construct any unspecified  	O	null

0 ב ב בתכלת preposition unspecified unspecified unspecified unspecified unspecified 0 
0 תכלת תכלת בתכלת noun feminine singular construct unspecified unspecified  	O	null

0 עיניים עין עיניים noun feminine plural absolute unspecified unspecified  	O	null

0 ימים יום ימים noun masculine plural absolute unspecified unspecified  	O	null

0 של של של shel-preposition unspecified unspecified unspecified unspecified unspecified  	O	null

0 חול חול חול noun masculine singular absolute unspecified unspecified  	O	null

0 ו ו וחג conjunction unspecified unspecified unspecified unspecified unspecified 0 
0 חג חג וחג noun masculine singular absolute unspecified unspecified  	O	null

0 כחול כחול כחול adjective masculine singular absolute unspecified unspecified  	O	null

0 ירושלים ירושלים ירושלים properName unspecified unspecified unspecified unspecified unspecified  	I_LOC	null

0 גינת גינת גינת properName unspecified unspecified unspecified unspecified unspecified  	I_PERS	null

0 חיי חיים חיי noun masculine plural construct unspecified unspecified  	O	null

0 ו ו ואני conjunction unspecified unspecified unspecified unspecified unspecified 0 
0 אני הוא ואני pronoun masculine-and-feminine singular unspecified 1 unspecified  	O	null

0 ב ב בה preposition unspecified unspecified unspecified unspecified unspecified  
0 ה ה בה pronomial feminine singular unspecified 3 unspecified 0 	O	null

0 אדש אדש אדשא noun masculine singular absolute unspecified unspecified  
0 י י אדשא possessive masculine-and-feminine singular unspecified 1 unspecified 0 	O	null

0 דשא דשא דשא noun masculine singular absolute unspecified unspecified  	O	null

0 עשב עשב עשב noun masculine singular absolute unspecified unspecified  	O	null

0 ו ו והחמלה conjunction unspecified unspecified unspecified unspecified unspecified 0 
0 ה ה והחמלה definiteArticle unspecified unspecified unspecified unspecified unspecified 0 
0 החמלה חמלה והחמלה noun feminine singular absolute unspecified unspecified  	O	null

0 ה ה העגולה definiteArticle unspecified unspecified unspecified unspecified unspecified 0 
0 העגולה עגול העגולה adjective feminine singular absolute unspecified unspecified  	O	null

0 ירושלים ירושלים ירושלים properName unspecified unspecified unspecified unspecified unspecified  	I_LOC	null

0 קו קו קו noun masculine singular construct unspecified unspecified  	O	null

0 חומות חומה חומותי noun feminine plural absolute unspecified unspecified  
0 י י חומותי possessive masculine-and-feminine singular unspecified 1 unspecified 0 	O	null

0 ו ו ואני conjunction unspecified unspecified unspecified unspecified unspecified 0 
0 אני הוא ואני pronoun masculine-and-feminine singular unspecified 1 unspecified  	O	null

0 ב ב בחומה preposition unspecified unspecified unspecified unspecified unspecified 0 
0 חומה חומה בחומה noun feminine singular absolute unspecified unspecified  	O	null

0 אבן אבן אבן noun feminine singular absolute unspecified unspecified  	O	null

0 קשת קשה קשת adjective feminine singular construct unspecified unspecified  	O	null

0 כבד כבד כבד adjective masculine singular absolute unspecified unspecified  	O	null

0 ה ה העול definiteArticle unspecified unspecified unspecified unspecified unspecified 0 
0 העול עול העול noun masculine singular absolute unspecified unspecified  	O	null

0 נעים נעים נעים properName masculine singular unspecified unspecified unspecified  	I_PERS	null

0 ה ה העול definiteArticle unspecified unspecified unspecified unspecified unspecified 0 
0 העול עול העול noun masculine singular absolute unspecified unspecified  	O	null

0 ירושלים ירושלים ירושלים properName unspecified unspecified unspecified unspecified unspecified  	I_LOC	null

0 קרעי קרע קרעי noun masculine plural construct unspecified unspecified  	O	null

0 חלום חלום חלום noun masculine singular absolute unspecified unspecified  	O	null

0 שיר שיר שיר noun masculine singular absolute unspecified unspecified  	O	null

0 מינים מין מינים noun masculine plural absolute unspecified unspecified  	O	null

0 ו ו ועשור conjunction unspecified unspecified unspecified unspecified unspecified 0 
0 עשור עשור ועשור noun masculine singular absolute unspecified unspecified  	O	null

0 לך הלך לך verb masculine singular unspecified 2 imperative  	O	null

0 שולח שולח שולח noun masculine singular construct unspecified unspecified  	O	null

0 עיני עין עיני noun feminine plural construct unspecified unspecified  	O	null

0 אפקח פקח אפקח verb masculine-and-feminine singular unspecified 1 future  	O	null

0 אל אל אל preposition unspecified unspecified unspecified unspecified unspecified  	O	null

0 ה ה המזרח definiteArticle unspecified unspecified unspecified unspecified unspecified 0 
0 המזרח מזרח המזרח noun masculine singular absolute unspecified unspecified  	O	null

0 ירושלים ירושלים ירושלים properName unspecified unspecified unspecified unspecified unspecified  	I_LOC	null

0 היי הי היי interjection unspecified unspecified unspecified unspecified unspecified  	O	null

0 שלום שלום שלום noun masculine singular construct unspecified unspecified  	O	null

0 עיר עיר עיר noun feminine singular construct unspecified unspecified  	O	null

0 מקלט מקלט מקלט noun masculine singular absolute unspecified unspecified  	O	null

0 ו ו וקרנות conjunction unspecified unspecified unspecified unspecified unspecified 0 
0 קרנות קרן וקרנות noun feminine plural absolute unspecified unspecified  	O	null

0 ה ה המזבח definiteArticle unspecified unspecified unspecified unspecified unspecified 0 
0 המזבח מזבח המזבח noun masculine singular absolute unspecified unspecified  	O	null

