0 מביט הביט מביט verb masculine singular unspecified any beinoni  	O	null

0 ב ב בעיני preposition unspecified unspecified unspecified unspecified unspecified 0 
0 עיני עין בעיני noun feminine plural construct unspecified unspecified  	O	null

0 יוצא יוצא יוצא noun masculine singular absolute unspecified unspecified  	O	null

0 מ מ מחיי preposition unspecified unspecified unspecified unspecified unspecified 0 
0 חיי חיים מחיי noun masculine plural construct unspecified unspecified  	O	null

0 ליבי ליבי ליבי properName unspecified unspecified unspecified unspecified unspecified  	I_PERS	null

0 מתחנן התחנן מתחנן verb masculine singular unspecified any beinoni  	O	null

0 תחזור חזר תחזור verb feminine singular unspecified 3 future  	O	null

0 אלי אל אלי noun masculine plural construct unspecified unspecified  	O	null

0 כל כול כל quantifier unspecified unspecified construct unspecified unspecified  	O	null

0 יום יום יום noun masculine singular absolute unspecified unspecified  	O	null

0 ש ש שחולף relativizer/subordinatingConjunction unspecified unspecified unspecified unspecified unspecified 0 
0 חולף חלף שחולף verb masculine singular unspecified any beinoni  	O	null

0 את את את at-preposition unspecified unspecified unspecified unspecified unspecified  	O	null

0 ה ה הכאב definiteArticle unspecified unspecified unspecified unspecified unspecified 0 
0 הכאב כאב הכאב noun masculine singular absolute unspecified unspecified  	I_DATE	null

0 שוטף שוטף שוטף adjective masculine singular absolute unspecified unspecified  	O	null

0 ברוך ברוך ברוך properName unspecified unspecified unspecified unspecified unspecified  	I_PERS	null

0 את את אותי at-preposition unspecified unspecified unspecified unspecified unspecified  
0 י י אותי pronomial masculine-and-feminine singular unspecified 1 unspecified 0 	O	null

0 עוטף עטף עוטף verb masculine singular unspecified any beinoni  	O	null

