0 מה מה מה interrogative unspecified unspecified unspecified unspecified unspecified  	O	null

0 מה מה מה interrogative unspecified unspecified unspecified unspecified unspecified  	O	null

0 נותר נותר נותר verb masculine singular unspecified 3 past  	O	null

0 ל ל לשיר preposition unspecified unspecified unspecified unspecified unspecified 0 
0 שיר שיר לשיר noun masculine singular absolute unspecified unspecified  	O	null

0 אחרי אחרי אחרי preposition unspecified unspecified unspecified unspecified unspecified  	O	null

0 זמיר זמיר זמיר properName unspecified unspecified unspecified unspecified unspecified  	I_PERS	null

0 אחר אחר אחר adjective masculine singular absolute unspecified unspecified  	O	null

0 נעים נעים נעים properName masculine singular unspecified unspecified unspecified  	I_PERS	null

0 זמירות זמירה זמירות noun feminine plural absolute unspecified unspecified  	O	null

0 יש יש יש existential unspecified unspecified unspecified unspecified unspecified  	O	null

0 כש כש כשהלב temporalSubConj unspecified unspecified unspecified unspecified unspecified 0 
0 ה ה כשהלב definiteArticle unspecified unspecified unspecified unspecified unspecified 0 
0 הלב לב כשהלב noun masculine singular absolute unspecified unspecified  	O	null

0 עולץ עלץ עולץ verb masculine singular unspecified any beinoni  	O	null

0 גם גם גם conjunction unspecified unspecified unspecified unspecified unspecified  	O	null

0 יונה יונה יונה properName unspecified unspecified unspecified unspecified unspecified  	I_PERS	null

0 גם גם גם conjunction unspecified unspecified unspecified unspecified unspecified  	O	null

0 נץ נץ נץ noun masculine singular absolute unspecified unspecified  	O	null

0 ינעימו הנעים ינעימו verb masculine-and-feminine plural unspecified 3 future  	O	null

0 ב ב בנגינות preposition unspecified unspecified unspecified unspecified unspecified 0 
0 נגינות נגינה בנגינות noun feminine plural absolute unspecified unspecified  	O	null

