0 ירושלים ירושלים ירושלים properName unspecified unspecified unspecified unspecified unspecified  	I_LOC	null

0 עיר עיר עיר noun feminine singular construct unspecified unspecified  	O	null

0 כלה כלה כלה noun feminine singular absolute unspecified unspecified  	O	null

0 כחולת כחול כחולת adjective feminine singular construct unspecified unspecified  	O	null

0 עיניים עין עיניים noun feminine plural absolute unspecified unspecified  	O	null

0 ירושלים ירושלים ירושלים properName unspecified unspecified unspecified unspecified unspecified  	I_LOC	null

0 עיר עיר עיר noun feminine singular construct unspecified unspecified  	O	null

0 של של של shel-preposition unspecified unspecified unspecified unspecified unspecified  	O	null

0 שמש שמש שמש properName unspecified unspecified unspecified unspecified unspecified  	I_PERS	null

0 ו ו ופסגות conjunction unspecified unspecified unspecified unspecified unspecified 0 
0 פסגות פסגה ופסגות noun feminine plural absolute unspecified unspecified  	O	null

0 ב ב בשמחת preposition unspecified unspecified unspecified unspecified unspecified 0 
0 שמחת שמחה בשמחת noun feminine singular construct unspecified unspecified  	O	null

0 כלולות כלולות כלולותיך noun feminine plural absolute unspecified unspecified  
0 ך ך כלולותיך possessive feminine singular unspecified 2 unspecified 0 	O	null

0 יקיפוך יקיפוך יקיפוך adjective feminine plural construct unspecified unspecified  	O	null

0 כל כול כל quantifier unspecified unspecified construct unspecified unspecified  	O	null

0 דודי דוד דודיך noun masculine plural absolute unspecified unspecified  
0 ך ך דודיך possessive feminine singular unspecified 2 unspecified 0 	O	null

0 ב ב במחולות preposition unspecified unspecified unspecified unspecified unspecified 0 
0 מחולות מחול במחולות noun masculine plural absolute unspecified unspecified  	O	null

0 ה ה המחניים definiteArticle unspecified unspecified unspecified unspecified unspecified 0 
0 המחניים מחניים המחניים noun masculine dual absolute unspecified unspecified  	O	null

0 ל ל לקולו preposition unspecified unspecified unspecified unspecified unspecified 0 
0 קול קול לקולו noun masculine singular absolute unspecified unspecified  
0 ו ו לקולו possessive masculine singular unspecified 3 unspecified 0 	O	null

0 של של של shel-preposition unspecified unspecified unspecified unspecified unspecified  	O	null

0 תוף תוף תוף noun masculine singular construct unspecified unspecified  	O	null

0 מרים מרים מרים properName unspecified unspecified unspecified unspecified unspecified  	I_PERS	null

0 אם אם אם conjunction unspecified unspecified unspecified unspecified unspecified  	O	null

0 אשכחך אשכחך אשכחך noun masculine singular absolute unspecified unspecified  	O	null

0 ירושלים ירושלים ירושלים properName unspecified unspecified unspecified unspecified unspecified  	I_LOC	null

0 אם אם אם conjunction unspecified unspecified unspecified unspecified unspecified  	O	null

0 אשכחך אשכחך אשכחך noun masculine singular absolute unspecified unspecified  	O	null

0 תשכח שכח תשכח verb feminine singular unspecified 3 future  	O	null

0 ימיני ימין ימיני noun masculine plural construct unspecified unspecified  	O	null

0 ל ל לחומותייך preposition unspecified unspecified unspecified unspecified unspecified 0 
0 חומותי חומה לחומותייך noun feminine plural absolute unspecified unspecified  
0 ך ך לחומותייך possessive feminine singular unspecified 2 unspecified 0 	O	null

0 נשק נשק נשקו noun masculine singular absolute unspecified unspecified  
0 ו ו נשקו possessive masculine singular unspecified 3 unspecified 0 	O	null

0 כל כול כל quantifier unspecified unspecified construct unspecified unspecified  	O	null

0 גיבוריי גיבור גיבורייך noun masculine plural absolute unspecified unspecified  
0 ך ך גיבורייך possessive feminine singular unspecified 2 unspecified 0 	O	null

0 ב ב בשבועתם preposition unspecified unspecified unspecified unspecified unspecified 0 
0 שבועת שבועה בשבועתם noun feminine singular absolute unspecified unspecified  
0 ם ם בשבועתם possessive masculine plural unspecified 3 unspecified 0 	O	null

0 לך הלך לך verb masculine singular unspecified 2 imperative  	O	null

0 לבב לבב לבבם noun masculine singular absolute unspecified unspecified  
0 ם ם לבבם possessive masculine plural unspecified 3 unspecified 0 	O	null

0 קשרו קשר קשרו verb masculine-and-feminine plural unspecified 3 past  	O	null

0 עם עם עמך noun masculine singular absolute unspecified unspecified  
0 ך ך עמך possessive feminine singular unspecified 2 unspecified 0 	O	null

0 ו ו ותפילה conjunction unspecified unspecified unspecified unspecified unspecified 0 
0 תפילה תפילה ותפילה noun feminine singular absolute unspecified unspecified  	O	null

0 אחת CARD1 אחת numeral feminine singular absolute unspecified unspecified  	O	null

0 מונחת הונח מונחת verb feminine singular unspecified any beinoni  	O	null

0 ב ב בכותלו preposition unspecified unspecified unspecified unspecified unspecified 0 
0 כותל כותל בכותלו noun masculine singular absolute unspecified unspecified  
0 ו ו בכותלו possessive masculine singular unspecified 3 unspecified 0 	O	null

0 של של של shel-preposition unspecified unspecified unspecified unspecified unspecified  	O	null

0 הר הר הר properName unspecified unspecified unspecified unspecified unspecified  	I_PERS	null

0 ה ה הבית definiteArticle unspecified unspecified unspecified unspecified unspecified 0 
0 הבית בית הבית noun masculine singular absolute unspecified unspecified  	O	null

0 ה ה השומרת definiteArticle unspecified unspecified unspecified unspecified unspecified 0 
0 השומרת שומר השומרת noun feminine singular absolute unspecified unspecified  	O	null

0 יום יום יום noun masculine singular absolute unspecified unspecified  	O	null

0 ו ו וליל conjunction unspecified unspecified unspecified unspecified unspecified 0 
0 ליל ליל וליל noun masculine singular construct unspecified unspecified  	O	null

0 את את את at-preposition unspecified unspecified unspecified unspecified unspecified  	O	null

0 גחלת גחלת גחלת noun feminine singular construct unspecified unspecified  	O	null

0 כלולתך כלולתך כלולתך adjective feminine plural construct unspecified unspecified  	O	null

0 אם אם אם conjunction unspecified unspecified unspecified unspecified unspecified  	O	null

0 אשכחך אשכחך אשכחך noun masculine singular absolute unspecified unspecified  	O	null

