0 דְּרוֹר דְּרוֹר דְּרוֹר verb masculine singular unspecified 2 imperative  	O	null

0 יִקְרָא יִקְרָא יִקְרָא verb masculine singular unspecified 2 imperative  	O	null

0 לְבֵן לְבֵן לְבֵן adjective masculine singular construct unspecified unspecified  	O	null

0 עִם עִם עִם noun masculine singular construct unspecified unspecified  	O	null

0 בַּת בַּת בַּת verb feminine singular unspecified 2 past  	O	null

0 וְיִנְצָרְכֶם וְיִנְצָרְכֶם וְיִנְצָרְכֶם verb feminine singular unspecified 2 imperative  	O	null

0 כְּמו כְּמו כְּמו preposition unspecified unspecified unspecified unspecified unspecified  	O	null
1 ֹ ֹ ֹ punctuation unspecified unspecified unspecified unspecified unspecified  	O	null

0 בָבַת בָבַת בָבַת verb feminine singular unspecified 2 past  	O	null

0 נְעִים נְעִים נְעִים participle masculine singular construct any unspecified  	O	null

0 שִׁמְכֶם שִׁמְכֶם שִׁמְכֶם adjective masculine plural construct unspecified unspecified  	O	null

0 ו ו וְלֹא conjunction unspecified unspecified unspecified unspecified unspecified 0 
0 ְלֹא ְלֹא וְלֹא adjective masculine singular construct unspecified unspecified  	O	null

0 יֻשְׁבַּת יֻשְׁבַּת יֻשְׁבַּת verb feminine singular unspecified 2 past  	O	null

0 שְׁבו שְׁבו שְׁבו properName unspecified unspecified unspecified unspecified unspecified  	I_PERS	null
1 ּ ּ ּ punctuation unspecified unspecified unspecified unspecified unspecified  	O	null

0 נוּחו נוּחו נוּחו properName unspecified unspecified unspecified unspecified unspecified  	I_PERS	null
1 ּ ּ ּ punctuation unspecified unspecified unspecified unspecified unspecified  	O	null

0 בְּיוֹם בְּיוֹם בְּיוֹם verb masculine singular unspecified 2 imperative  	O	null

0 שַׁבָּת שַׁבָּת שַׁבָּת verb masculine singular unspecified 2 imperative  	O	null

