0 Haloooooo Haloooooo Haloooooo foreign unspecified unspecified unspecified unspecified unspecified  	I_ORG	null

0 this this this foreign unspecified unspecified unspecified unspecified unspecified  	I_ORG	null

0 is is is foreign unspecified unspecified unspecified unspecified unspecified  	I_ORG	null

0 the the the foreign unspecified unspecified unspecified unspecified unspecified  	I_ORG	null

0 song song song foreign unspecified unspecified unspecified unspecified unspecified  	I_ORG	null

0 for for for foreign unspecified unspecified unspecified unspecified unspecified  	I_ORG	null

0 the the the foreign unspecified unspecified unspecified unspecified unspecified  	I_ORG	null

0 Knesset Knesset Knesset foreign unspecified unspecified unspecified unspecified unspecified  	I_ORG	null

0 of of of foreign unspecified unspecified unspecified unspecified unspecified  	I_ORG	null

0 Israel Israel Israel foreign unspecified unspecified unspecified unspecified unspecified  	I_ORG	null

0 ###NUMBER### ###NUMBER### ###NUMBER### numeral unspecified unspecified unspecified unspecified unspecified  	I_DATE	null

0 We We We foreign unspecified unspecified unspecified unspecified unspecified  	I_ORG	null

0 pray pray pray foreign unspecified unspecified unspecified unspecified unspecified  	I_ORG	null

0 for for for foreign unspecified unspecified unspecified unspecified unspecified  	I_ORG	null

0 peace peace peace foreign unspecified unspecified unspecified unspecified unspecified  	I_ORG	null

0 for for for foreign unspecified unspecified unspecified unspecified unspecified  	I_ORG	null

0 all all all foreign unspecified unspecified unspecified unspecified unspecified  	I_ORG	null

0 the the the foreign unspecified unspecified unspecified unspecified unspecified  	I_ORG	null

0 nation nation nation foreign unspecified unspecified unspecified unspecified unspecified  	I_ORG	null

0 It It It foreign unspecified unspecified unspecified unspecified unspecified  	I_ORG	null

0 s s s foreign unspecified unspecified unspecified unspecified unspecified  	I_ORG	null

0 coming coming coming foreign unspecified unspecified unspecified unspecified unspecified  	I_ORG	null

0 from from from foreign unspecified unspecified unspecified unspecified unspecified  	I_ORG	null

0 the the the foreign unspecified unspecified unspecified unspecified unspecified  	I_ORG	null

0 voice voice voice foreign unspecified unspecified unspecified unspecified unspecified  	I_ORG	null

0 the the the foreign unspecified unspecified unspecified unspecified unspecified  	I_ORG	null

0 immigrations immigrations immigrations foreign unspecified unspecified unspecified unspecified unspecified  	I_ORG	null

0 God God God foreign unspecified unspecified unspecified unspecified unspecified  	I_ORG	null

0 bless bless bless foreign unspecified unspecified unspecified unspecified unspecified  	I_ORG	null

0 all all all foreign unspecified unspecified unspecified unspecified unspecified  	I_ORG	null

0 of of of foreign unspecified unspecified unspecified unspecified unspecified  	I_ORG	null

0 the the the foreign unspecified unspecified unspecified unspecified unspecified  	I_ORG	null

0 competitions competitions competitions foreign unspecified unspecified unspecified unspecified unspecified  	I_ORG	null

0 Let Let Let foreign unspecified unspecified unspecified unspecified unspecified  	I_ORG	null

0 s s s foreign unspecified unspecified unspecified unspecified unspecified  	I_ORG	null

0 all all all foreign unspecified unspecified unspecified unspecified unspecified  	I_ORG	null

0 sing sing sing foreign unspecified unspecified unspecified unspecified unspecified  	I_ORG	null

0 a a a foreign unspecified unspecified unspecified unspecified unspecified  	I_ORG	null

0 song song song foreign unspecified unspecified unspecified unspecified unspecified  	I_ORG	null

0 for for for foreign unspecified unspecified unspecified unspecified unspecified  	I_ORG	null

0 the the the foreign unspecified unspecified unspecified unspecified unspecified  	I_ORG	null

0 nominations nominations nominations foreign unspecified unspecified unspecified unspecified unspecified  	I_ORG	null

0 And And And foreign unspecified unspecified unspecified unspecified unspecified  	I_ORG	null

0 these these these foreign unspecified unspecified unspecified unspecified unspecified  	I_ORG	null

0 are are are foreign unspecified unspecified unspecified unspecified unspecified  	I_ORG	null

0 the the the foreign unspecified unspecified unspecified unspecified unspecified  	I_ORG	null

0 names names names foreign unspecified unspecified unspecified unspecified unspecified  	I_ORG	null

0 of of of foreign unspecified unspecified unspecified unspecified unspecified  	I_ORG	null

0 the the the foreign unspecified unspecified unspecified unspecified unspecified  	I_ORG	null

0 runner runner runner foreign unspecified unspecified unspecified unspecified unspecified  	I_ORG	null

0 ups ups ups foreign unspecified unspecified unspecified unspecified unspecified  	I_ORG	null

0 Good Good Good foreign unspecified unspecified unspecified unspecified unspecified  	I_ORG	null

0 luck luck luck foreign unspecified unspecified unspecified unspecified unspecified  	I_ORG	null

0 to to to foreign unspecified unspecified unspecified unspecified unspecified  	I_ORG	null

0 you you you foreign unspecified unspecified unspecified unspecified unspecified  	I_ORG	null

0 all all all foreign unspecified unspecified unspecified unspecified unspecified  	I_ORG	null

0 אילן אילן אילן properName unspecified unspecified unspecified unspecified unspecified  	I_PERS	null

0 - - - punctuation unspecified unspecified unspecified unspecified unspecified  	O	null

0 הרטשטיין הרטשטיין הרטשטיין properName unspecified unspecified unspecified unspecified unspecified  	O	null

0 אלהרר אלהרר אלהרר adverb unspecified unspecified unspecified unspecified unspecified  	O	null

0 ילין ילין ילין properName unspecified unspecified unspecified unspecified unspecified  	I_PERS	null

0 גילאון גילאון גילאון properName unspecified unspecified unspecified unspecified unspecified  	I_PERS	null

0 יונה יונה יונה properName unspecified unspecified unspecified unspecified unspecified  	I_PERS	null

0 ה ה הכהן definiteArticle unspecified unspecified unspecified unspecified unspecified 0 
0 הכהן כהן הכהן noun masculine singular absolute unspecified unspecified  	O	null

0 בגין בגין בגין properName masculine singular unspecified unspecified unspecified  	O	null

0 ש ש שטבון relativizer/subordinatingConjunction unspecified unspecified unspecified unspecified unspecified 0 
0 טבון טבון שטבון noun masculine singular absolute unspecified unspecified  	O	null

0 אבו אבו אבו properName unspecified unspecified unspecified unspecified unspecified  	I_PERS	null

0 מ מ מערוף preposition unspecified unspecified unspecified unspecified unspecified 0 
0 ערוף ערף מערוף participle masculine singular absolute any unspecified  	O	null

0 אבו אבו אבו properName unspecified unspecified unspecified unspecified unspecified  	I_PERS	null

0 עראר עראר עראר properName unspecified unspecified unspecified unspecified unspecified  	O	null

0 ארדן ארדן ארדן properName unspecified unspecified unspecified unspecified unspecified  	O	null

0 אלקין אלקין אלקין properName unspecified unspecified unspecified unspecified unspecified  	O	null

0 פירון פירון פירון properName unspecified unspecified unspecified unspecified unspecified  	O	null

0 חנין חנין חנין properName unspecified unspecified unspecified unspecified unspecified  	O	null

0 כחלון כחלון כחלון properName unspecified unspecified unspecified unspecified unspecified  	I_PERS	null

0 יעלון יעלון יעלון properName unspecified unspecified unspecified unspecified unspecified  	O	null

0 לוין לוין לוין properName unspecified unspecified unspecified unspecified unspecified  	I_PERS	null

0 דנון דנון דנון properName unspecified unspecified unspecified unspecified unspecified  	I_PERS	null

0 פולקמן פולקמן פולקמן properName unspecified unspecified unspecified unspecified unspecified  	O	null

0 ב ב בהלול preposition unspecified unspecified unspecified unspecified unspecified 0 
0 ה ה בהלול definiteArticle unspecified unspecified unspecified unspecified unspecified 0 
0 ההלול לול בהלול noun masculine singular absolute unspecified unspecified  	O	null

0 שלום שלום שלום noun masculine singular construct unspecified unspecified  	O	null

0 לביא לביא לביא properName unspecified unspecified unspecified unspecified unspecified  	I_PERS	null

0 עטר עטר עטר verb masculine singular unspecified 3 past  	O	null

0 חסון חיסון חסון noun masculine singular absolute unspecified unspecified  	O	null

0 נתניהו נתניהו נתניהו properName unspecified unspecified unspecified unspecified unspecified  	I_PERS	null

0 גלאון גלאון גלאון properName unspecified unspecified unspecified unspecified unspecified  	I_PERS	null

0 יעל ייעל יעל verb masculine singular unspecified 3 past  	O	null

0 - - - punctuation unspecified unspecified unspecified unspecified unspecified  	O	null

0 נחמיאס נחמיאס נחמיאס properName unspecified unspecified unspecified unspecified unspecified  	I_PERS	null

0 ורבין ורבין ורבין properName unspecified unspecified unspecified unspecified unspecified  	I_PERS	null

0 רוזנטל רוזנטל רוזנטל properName unspecified unspecified unspecified unspecified unspecified  	I_PERS	null

0 ליברמן ליברמן ליברמן properName unspecified unspecified unspecified unspecified unspecified  	I_PERS	null

0 and and and foreign unspecified unspecified unspecified unspecified unspecified  	I_ORG	null

0 miss miss miss foreign unspecified unspecified unspecified unspecified unspecified  	I_ORG	null

0 גרם גרם גרמן noun masculine singular absolute unspecified unspecified  
0 ן ן גרמן possessive feminine plural unspecified 3 unspecified 0 	O	null

0 גמליאל גמליאל גמליאל properName unspecified unspecified unspecified unspecified unspecified  	I_PERS	null

0 ברק ברק ברקו noun masculine singular absolute unspecified unspecified  
0 ו ו ברקו possessive masculine singular unspecified 3 unspecified 0 	O	null

0 גטאס גטאס גטאס properName unspecified unspecified unspecified unspecified unspecified  	O	null

0 ליצמן ליצמן ליצמן properName unspecified unspecified unspecified unspecified unspecified  	O	null

0 אמסלם אמסלם אמסלם properName unspecified unspecified unspecified unspecified unspecified  	I_PERS	null

0 שוחט שוחט שוחט properName unspecified unspecified unspecified unspecified unspecified  	I_PERS	null

0 מועלם הועלם מועלם verb masculine singular unspecified any beinoni  	O	null

0 שטרן שטרן שטרן properName unspecified unspecified unspecified unspecified unspecified  	I_PERS	null

0 אורן אורן אורן properName masculine singular unspecified unspecified unspecified  	I_PERS	null

0 טיבי טיב טיבי properName unspecified unspecified unspecified unspecified unspecified  	I_PERS	null

0 עייש עייש עייש properName unspecified unspecified unspecified unspecified unspecified  	O	null

0 בירן בירן בירן properName masculine singular unspecified unspecified unspecified  	I_PERS	null

0 בן בן בן properName unspecified unspecified unspecified unspecified unspecified  	I_PERS	null

0 ארי ארי ארי properName unspecified unspecified unspecified unspecified unspecified  	I_PERS	null

0 בן בן בן properName unspecified unspecified unspecified unspecified unspecified  	I_PERS	null

0 ראובן ראובן ראובן properName unspecified unspecified unspecified unspecified unspecified  	I_PERS	null

0 שפיר שפיר שפיר properName unspecified unspecified unspecified unspecified unspecified  	I_PERS	null

0 בר בר בר properName unspecified unspecified unspecified unspecified unspecified  	I_PERS	null

0 פרץ פרץ פרץ properName masculine singular unspecified unspecified unspecified  	I_PERS	null

0 ה ה הכהן definiteArticle unspecified unspecified unspecified unspecified unspecified 0 
0 הכהן כהן הכהן noun masculine singular absolute unspecified unspecified  	O	null

0 גפני גפני גפני properName unspecified unspecified unspecified unspecified unspecified  	I_PERS	null

0 בנט בנט בנט adverb unspecified unspecified unspecified unspecified unspecified  	O	null

0 ל ל לנדבר preposition unspecified unspecified unspecified unspecified unspecified 0 
0 נדבר נדבר לנדבר participle masculine singular absolute any unspecified  	O	null

0 יוגב יוגב יוגב properName unspecified unspecified unspecified unspecified unspecified  	I_PERS	null

0 פרי פרי פרי properName unspecified unspecified unspecified unspecified unspecified  	I_PERS	null

0 ש ש שמולי relativizer/subordinatingConjunction unspecified unspecified unspecified unspecified unspecified 0 
0 מול מול שמולי preposition unspecified unspecified unspecified unspecified unspecified  
0 י י שמולי pronomial masculine-and-feminine singular unspecified 1 unspecified 0 	O	null

0 כבל כבל כבל verb masculine singular unspecified 3 past  	O	null

0 פרחי פרח פרחי noun masculine plural construct unspecified unspecified  	O	null

0 קרא קרא קרא verb masculine singular unspecified 3 past  	O	null

0 הרצוג הרצוג הרצוג properName unspecified unspecified unspecified unspecified unspecified  	I_PERS	null

0 ל ל לבני preposition unspecified unspecified unspecified unspecified unspecified 0 
0 בני בן לבני noun masculine plural construct unspecified unspecified  	O	null

0 מיכאלי מיכאלי מיכאלי properName unspecified unspecified unspecified unspecified unspecified  	I_PERS	null

0 חרום חירום חרומי noun masculine singular absolute unspecified unspecified  
0 י י חרומי possessive masculine-and-feminine singular unspecified 1 unspecified 0 	O	null

0 and and and foreign unspecified unspecified unspecified unspecified unspecified  	I_ORG	null

0 ברושי ברוש ברושי noun masculine plural construct unspecified unspecified  	O	null

0 אייטץ אייטץ אייטצ properName unspecified unspecified unspecified unspecified unspecified  	O	null

0 אה אה אה interjection unspecified unspecified unspecified unspecified unspecified  	O	null

0 קאצ׳י קאצ׳י קאצ׳י properName unspecified unspecified unspecified unspecified unspecified  	O	null

0 בייט בייט בייט properName unspecified unspecified unspecified unspecified unspecified  	O	null

0 איט איט איטצ noun masculine singular absolute unspecified unspecified  
0 ו ו איטצ possessive masculine singular unspecified 3 unspecified 0 	O	null
1 ׳ ׳ ׳ punctuation unspecified unspecified unspecified unspecified unspecified  	O	null

0 אה אה אה interjection unspecified unspecified unspecified unspecified unspecified  	O	null

0 קאלפי קאלפי קאלפי properName unspecified unspecified unspecified unspecified unspecified  	O	null

0 שיק שיק שיק noun masculine singular absolute unspecified unspecified  	O	null

0 אילן אילן אילן properName unspecified unspecified unspecified unspecified unspecified  	I_PERS	null

0 - - - punctuation unspecified unspecified unspecified unspecified unspecified  	O	null

0 שטייניץ שטייניץ שטייניץ properName unspecified unspecified unspecified unspecified unspecified  	I_PERS	null

0 לפיד לפיד לפיד properName unspecified unspecified unspecified unspecified unspecified  	I_PERS	null

0 שלח שלח שלח verb masculine singular unspecified 3 past  	O	null

0 מרגלית מרגלית מרגלית properName unspecified unspecified unspecified unspecified unspecified  	I_PERS	null

0 עוד עוד עודה noun masculine singular absolute unspecified unspecified  
0 ה ה עודה possessive feminine singular unspecified 3 unspecified 0 	O	null

0 תום תום תומא noun masculine singular absolute unspecified unspecified  
0 י י תומא possessive masculine-and-feminine singular unspecified 1 unspecified 0 	O	null

0 מוזס מוזס מוזס properName unspecified unspecified unspecified unspecified unspecified  	I_PERS	null

0 סוייד סויד סוייד verb masculine singular unspecified 3 past  	O	null

0 דהן דהן דהן properName unspecified unspecified unspecified unspecified unspecified  	I_PERS	null

0 טרבולסי טרבולסי טרבולסי properName unspecified unspecified unspecified unspecified unspecified  	O	null

0 אקוניס אקוניס אקוניס properName unspecified unspecified unspecified unspecified unspecified  	O	null

0 one one one foreign unspecified unspecified unspecified unspecified unspecified  	I_ORG	null

0 more more more foreign unspecified unspecified unspecified unspecified unspecified  	I_ORG	null

0 בן בן בן properName unspecified unspecified unspecified unspecified unspecified  	I_PERS	null

0 דהן דהן דהן properName unspecified unspecified unspecified unspecified unspecified  	I_PERS	null

0 פרי פרי פריג noun masculine singular absolute unspecified unspecified  
0 ה ה פריג possessive feminine singular unspecified 3 unspecified 0 	O	null
1 ׳ ׳ ׳ punctuation unspecified unspecified unspecified unspecified unspecified  	O	null

0 לוי לוי לוי properName unspecified unspecified unspecified unspecified unspecified  	I_PERS	null

0 אבקסיס אבקסיס אבקסיס properName unspecified unspecified unspecified unspecified unspecified  	I_PERS	null

0 עזריה עזריה עזריה properName unspecified unspecified unspecified unspecified unspecified  	I_PERS	null

0 שי שי שי properName unspecified unspecified unspecified unspecified unspecified  	I_PERS	null

0 אריאל אריאל אריאל properName unspecified unspecified unspecified unspecified unspecified  	I_PERS	null

0 כהן כהן כהן properName masculine singular unspecified unspecified unspecified  	I_PERS	null

0 אדלשטיין אדלשטיין אדלשטיין properName unspecified unspecified unspecified unspecified unspecified  	I_PERS	null

0 מרזל מרזל מרזל properName unspecified unspecified unspecified unspecified unspecified  	O	null

0 זועבי זועבי זועבי properName unspecified unspecified unspecified unspecified unspecified  	I_PERS	null

0 They They They foreign unspecified unspecified unspecified unspecified unspecified  	I_ORG	null

0 come come come foreign unspecified unspecified unspecified unspecified unspecified  	I_ORG	null

0 and and and foreign unspecified unspecified unspecified unspecified unspecified  	I_ORG	null

0 they they they foreign unspecified unspecified unspecified unspecified unspecified  	I_ORG	null

0 go go go foreign unspecified unspecified unspecified unspecified unspecified  	I_ORG	null

0 They They They foreign unspecified unspecified unspecified unspecified unspecified  	I_ORG	null

0 come come come foreign unspecified unspecified unspecified unspecified unspecified  	I_ORG	null

0 and and and foreign unspecified unspecified unspecified unspecified unspecified  	I_ORG	null

0 they they they foreign unspecified unspecified unspecified unspecified unspecified  	I_ORG	null

0 go go go foreign unspecified unspecified unspecified unspecified unspecified  	I_ORG	null

0 סלומינסקי סלומינסקי סלומינסקי properName unspecified unspecified unspecified unspecified unspecified  	O	null

0 סמוטריץ סמוטריץ סמוטריץ properName unspecified unspecified unspecified unspecified unspecified  	O	null

0 סעדיה סעדיה סעדיה properName unspecified unspecified unspecified unspecified unspecified  	I_PERS	null

0 יחימוביץ יחימוביץ יחימוביץ properName unspecified unspecified unspecified unspecified unspecified  	O	null

0 קיש קיש קיש noun masculine singular absolute unspecified unspecified  	O	null

0 סבטלוב סבטלוב סבטלוב participle feminine plural construct any unspecified  	O	null

0 טרכטנברג טרכטנברג טרכטנברג properName unspecified unspecified unspecified unspecified unspecified  	O	null

0 אזברג׳ה אזברג׳ה אזברג׳ה verb masculine singular unspecified 2 imperative  	O	null

0 אשר אשר אשר properName masculine singular unspecified unspecified unspecified  	I_PERS	null

0 זהר זהר זהר verb masculine singular unspecified 3 past  	O	null

0 כץ כץ כץ properName unspecified unspecified unspecified unspecified unspecified  	I_PERS	null

0 כץ כץ כץ properName unspecified unspecified unspecified unspecified unspecified  	I_PERS	null

0 רוזין רוזין רוזין properName unspecified unspecified unspecified unspecified unspecified  	O	null

0 רז רז רז properName unspecified unspecified unspecified unspecified unspecified  	I_PERS	null

0 הנגבי הנגבי הנגבי properName unspecified unspecified unspecified unspecified unspecified  	I_PERS	null

0 חוטובלי חוטובלי חוטובלי properName unspecified unspecified unspecified unspecified unspecified  	O	null

0 גנאיים גנאי גנאיים adjective masculine plural absolute unspecified unspecified  	O	null

0 ש ש שאשא relativizer/subordinatingConjunction unspecified unspecified unspecified unspecified unspecified 0 
0 אשא נשא שאשא verb masculine-and-feminine singular unspecified 1 future  	O	null

0 פלוסקוב פלוסקוב פלוסקוב properName unspecified unspecified unspecified unspecified unspecified  	O	null

0 רונצקי רונצקי רונצקי properName unspecified unspecified unspecified unspecified unspecified  	O	null

0 גלנט גלנט גלנט properName unspecified unspecified unspecified unspecified unspecified  	O	null

0 ברלב ברלב ברלב properName unspecified unspecified unspecified unspecified unspecified  	I_PERS	null

0 סטרוק סטרוק סטרוק noun masculine singular absolute unspecified unspecified  	O	null

0 דרעי דרעי דרעי properName unspecified unspecified unspecified unspecified unspecified  	O	null

0 זנדברג זנדברג זנדברג properName unspecified unspecified unspecified unspecified unspecified  	I_PERS	null

0 וורצמן וורצמן וורצמן properName unspecified unspecified unspecified unspecified unspecified  	O	null

0 בורג בורג בורג properName unspecified unspecified unspecified unspecified unspecified  	O	null

0 אלאלוף אלאלוף אלאלוף properName unspecified unspecified unspecified unspecified unspecified  	I_PERS	null

0 רזבוזוב רזבוזוב רזבוזוב noun feminine plural construct unspecified unspecified  	O	null

0 חאג חאג חאג properName unspecified unspecified unspecified unspecified unspecified  	I_PERS	null
1 ׳ ׳ ׳ punctuation unspecified unspecified unspecified unspecified unspecified  	O	null

0 זחאלקה זחאלקה זחאלקה properName unspecified unspecified unspecified unspecified unspecified  	O	null

0 כהן כהן כהן properName masculine singular unspecified unspecified unspecified  	I_PERS	null

0 כהן כהן כהן properName masculine singular unspecified unspecified unspecified  	I_PERS	null

0 לוי לוי לוי properName unspecified unspecified unspecified unspecified unspecified  	I_PERS	null

0 לוי לוי לוי properName unspecified unspecified unspecified unspecified unspecified  	I_PERS	null

0 ישיי ישיי ישיי verb masculine singular unspecified 3 future  	O	null

0 ג׳אברין ג׳אברין ג׳אברין properName unspecified unspecified unspecified unspecified unspecified  	O	null

0 ב ב בהלול preposition unspecified unspecified unspecified unspecified unspecified 0 
0 ה ה בהלול definiteArticle unspecified unspecified unspecified unspecified unspecified 0 
0 ההלול לול בהלול noun masculine singular absolute unspecified unspecified  	O	null

0 ברלב ברלב ברלב properName unspecified unspecified unspecified unspecified unspecified  	I_PERS	null

0 שלום שלום שלום noun masculine singular construct unspecified unspecified  	O	null

0 לביא לביא לביא properName unspecified unspecified unspecified unspecified unspecified  	I_PERS	null

0 עטר עטר עטר verb masculine singular unspecified 3 past  	O	null

0 חסון חיסון חסון noun masculine singular absolute unspecified unspecified  	O	null

0 שקד שקד שקד properName masculine singular unspecified unspecified unspecified  	I_PERS	null

0 רגב רגב רגב properName unspecified unspecified unspecified unspecified unspecified  	I_PERS	null

0 מ מ מגל preposition unspecified unspecified unspecified unspecified unspecified 0 
0 גל גל מגל participle masculine singular absolute any unspecified  	O	null

0 גל גל גל noun masculine singular construct unspecified unspecified  	O	null

0 נהרי נהר נהרי verb feminine singular unspecified 2 imperative  	O	null

0 מרגי מרגי מרגי properName unspecified unspecified unspecified unspecified unspecified  	I_PERS	null

0 אזולאי אזולאי אזולאי properName unspecified unspecified unspecified unspecified unspecified  	I_PERS	null

0 אייכלר אייכלר אייכלר properName unspecified unspecified unspecified unspecified unspecified  	I_PERS	null

0 מקלב מקלב מקלב noun masculine singular absolute unspecified unspecified  	O	null

0 פרוש פרש פרוש verb masculine singular unspecified 2 imperative  	O	null

0 אייטץ אייטץ אייטצ properName unspecified unspecified unspecified unspecified unspecified  	O	null

0 אה אה אה interjection unspecified unspecified unspecified unspecified unspecified  	O	null

0 קאלפי קאלפי קאלפי properName unspecified unspecified unspecified unspecified unspecified  	O	null

0 שיק שיק שיק noun masculine singular absolute unspecified unspecified  	O	null

0 אייטץ אייטץ אייטצ properName unspecified unspecified unspecified unspecified unspecified  	O	null

0 אה אה אה interjection unspecified unspecified unspecified unspecified unspecified  	O	null

0 קאצי קאצי קאצי verb feminine singular unspecified 2 imperative  	O	null

0 בייט בייט בייט properName unspecified unspecified unspecified unspecified unspecified  	O	null

