0 אבא אבא אבא properName masculine singular unspecified unspecified unspecified  	O	null

0 שר שר שר noun masculine singular construct unspecified unspecified  	O	null

0 אני הוא אני pronoun masculine-and-feminine singular unspecified 1 unspecified  	O	null

0 לך הלך לך verb masculine singular unspecified 2 imperative  	O	null

0 על על על preposition unspecified unspecified unspecified unspecified unspecified  	O	null

0 ש ש שיום relativizer/subordinatingConjunction unspecified unspecified unspecified unspecified unspecified 0 
0 יום יום שיום noun masculine singular absolute unspecified unspecified  	O	null

0 אחד איחד אחד verb masculine singular unspecified 3 past  	O	null

0 קמת קמה קמת noun feminine singular construct unspecified unspecified  	O	null

0 ו ו ותלך conjunction unspecified unspecified unspecified unspecified unspecified 0 
0 תלך הלך ותלך verb feminine singular unspecified 3 future  	O	null

0 אמא אמא אמא noun feminine singular absolute unspecified unspecified  	O	null

0 זה זה זה pronoun masculine singular unspecified 3 unspecified  	O	null

0 ה ה השיר definiteArticle unspecified unspecified unspecified unspecified unspecified 0 
0 השיר שיר השיר noun masculine singular absolute unspecified unspecified  	O	null

0 הוא הוא הוא pronoun masculine singular unspecified 3 unspecified  	O	null

0 לך הלך לך verb masculine singular unspecified 2 imperative  	O	null

0 על על על preposition unspecified unspecified unspecified unspecified unspecified  	O	null

0 ימי יום ימי noun masculine plural construct unspecified unspecified  	O	null

0 לכת לכה לכתך noun feminine singular absolute unspecified unspecified  
0 ך ך לכתך possessive feminine singular unspecified 2 unspecified 0 	O	null

0 אחרי אחרי אחרי preposition unspecified unspecified unspecified unspecified unspecified  	O	null

0 אבי אבי אבי properName unspecified unspecified unspecified unspecified unspecified  	I_PERS	null

0 לכאן לכאן לכאן adverb unspecified unspecified unspecified unspecified unspecified  	O	null

0 שמש שמש שמש properName unspecified unspecified unspecified unspecified unspecified  	I_PERS	null

0 בא בא בא verb masculine singular unspecified 3 past  	O	null

0 אל אל אל preposition unspecified unspecified unspecified unspecified unspecified  	O	null

0 ה ה החלון definiteArticle unspecified unspecified unspecified unspecified unspecified 0 
0 החלון חילון החלון noun masculine singular absolute unspecified unspecified  	O	null

0 ענף ענף ענף noun masculine singular construct unspecified unspecified  	O	null

0 ירוק ירוק ירוק adjective masculine singular absolute unspecified unspecified  	O	null

0 מ מ מלילה preposition unspecified unspecified unspecified unspecified unspecified 0 
0 לילה לילה מלילה noun masculine singular absolute unspecified unspecified  	O	null

0 נעור עיוור נעור verb masculine-and-feminine plural unspecified 1 future  	O	null

0 ו ו וילד conjunction unspecified unspecified unspecified unspecified unspecified 0 
0 ילד ילד וילד noun masculine singular absolute unspecified unspecified  	O	null

0 ש ש שפקח relativizer/subordinatingConjunction unspecified unspecified unspecified unspecified unspecified 0 
0 פקח פקח שפקח verb masculine singular unspecified 3 past  	O	null

0 עין עין עיניו noun feminine plural absolute unspecified unspecified  
0 ו ו עיניו possessive masculine singular unspecified 3 unspecified 0 	O	null

0 ל ל לתכלת preposition unspecified unspecified unspecified unspecified unspecified 0 
0 תכלת תכלת לתכלת properName feminine singular unspecified unspecified unspecified  	I_PERS	null

0 כאן כאן כאן adverb unspecified unspecified unspecified unspecified unspecified  	O	null

0 ב ב בארץ preposition unspecified unspecified unspecified unspecified unspecified 0 
0 ארץ ארץ בארץ noun feminine singular construct unspecified unspecified  	O	null

0 אל אל אל preposition unspecified unspecified unspecified unspecified unspecified  	O	null

0 בצל בצל בצל noun masculine singular absolute unspecified unspecified  	O	null

0 כרמל כרמל כרמל properName unspecified unspecified unspecified unspecified unspecified  	I_PERS	null

0 ליד ליד ליד preposition unspecified unspecified unspecified unspecified unspecified  	O	null

0 ה ה הנחל definiteArticle unspecified unspecified unspecified unspecified unspecified 0 
0 הנחל נחל הנחל noun masculine singular absolute unspecified unspecified  	O	null

