0 רועפים רועפים רועפים verb masculine plural unspecified any beinoni  	O	null

0 נטפי נטף נטפי noun masculine plural construct unspecified unspecified  	O	null

0 ה ה הגשם definiteArticle unspecified unspecified unspecified unspecified unspecified 0 
0 הגשם גשם הגשם noun masculine singular absolute unspecified unspecified  	O	null

0 ירויון ירויון ירויון properName unspecified unspecified unspecified unspecified unspecified  	O	null

0 תלמי תלם תלמי noun masculine plural construct unspecified unspecified  	O	null

0 שדי שד שדי noun masculine plural construct unspecified unspecified  	O	null

0 חלק חלק חלקה noun masculine singular absolute unspecified unspecified  
0 ה ה חלקה possessive feminine singular unspecified 3 unspecified 0 	O	null

0 אחת CARD1 אחת numeral feminine singular absolute unspecified unspecified  	O	null

0 אם אם אם conjunction unspecified unspecified unspecified unspecified unspecified  	O	null

0 לא לא לא negation unspecified unspecified unspecified unspecified unspecified  	O	null

0 נמטרה נמטרה נמטרה verb masculine-and-feminine singular unspecified 1 future  	O	null

0 רוי רוי רוי properName unspecified unspecified unspecified unspecified unspecified  	I_PERS	null

0 תלמי תלם תלמיה noun masculine plural absolute unspecified unspecified  
0 ה ה תלמיה possessive feminine singular unspecified 3 unspecified 0 	O	null

0 דמעתי דמע דמעתי verb masculine-and-feminine singular unspecified 1 past  	O	null

0 מים מים מים noun masculine plural absolute unspecified unspecified  	O	null

0 סוף סוף סוף noun masculine singular construct unspecified unspecified  	O	null

0 ארבה ארבה ארבה noun masculine singular absolute unspecified unspecified  	O	null

0 הגיח הגיח הגיח verb masculine singular unspecified 3 past  	O	null

0 ו ו ויחסל conjunction unspecified unspecified unspecified unspecified unspecified 0 
0 יחסל חיסל ויחסל verb masculine singular unspecified 3 future  	O	null

0 כרמי כרם כרמי noun masculine plural construct unspecified unspecified  	O	null

0 כרמל כרמל כרמל properName unspecified unspecified unspecified unspecified unspecified  	I_PERS	null

0 אם אם אם conjunction unspecified unspecified unspecified unspecified unspecified  	O	null

0 גפן גפן גפן properName masculine singular unspecified unspecified unspecified  	I_PERS	null

0 חן חן חן noun masculine singular absolute unspecified unspecified  	O	null

0 אחת CARD1 אחת numeral feminine singular absolute unspecified unspecified  	O	null

0 נותרה נותר נותרה verb feminine singular unspecified 3 past  	O	null

0 תחסלנה חיסל תחסלנה verb feminine plural unspecified 2 future  	O	null

0 תוגת תוגה תוגתי noun feminine singular absolute unspecified unspecified  
0 י י תוגתי possessive masculine-and-feminine singular unspecified 1 unspecified 0 	O	null

