0 עיר עיר עיר noun feminine singular construct unspecified unspecified  	O	null

0 גדולה גדול גדולה adjective feminine singular absolute unspecified unspecified  	O	null

0 בלי בלי בלי preposition unspecified unspecified unspecified unspecified unspecified  	O	null

0 חיילים חייל חיילים noun masculine plural absolute unspecified unspecified  	O	null

0 ו ו ואי conjunction unspecified unspecified unspecified unspecified unspecified 0 
0 אי אי ואי noun masculine singular construct unspecified unspecified  	O	null

0 אפשר אפשר אפשר modal unspecified unspecified unspecified unspecified unspecified  	O	null

0 לישון ישן לישון verb unspecified unspecified unspecified unspecified infinitive  	O	null

0 פעמונים פעמון פעמונים noun masculine plural absolute unspecified unspecified  	O	null

0 מצלצלים צלצל מצלצלים verb masculine plural unspecified any beinoni  	O	null

0 ב ב בבוקר preposition unspecified unspecified unspecified unspecified unspecified 0 
0 בוקר בוקר בבוקר noun masculine singular absolute unspecified unspecified  	O	null

0 יום יום יום noun masculine singular absolute unspecified unspecified  	O	null

0 ראשון ORD1 ראשון numeral masculine singular absolute unspecified unspecified  	O	null

0 ירח ירח ירח noun masculine singular absolute unspecified unspecified  	O	null

0 קר קר קר adjective masculine singular absolute unspecified unspecified  	O	null

0 על על על preposition unspecified unspecified unspecified unspecified unspecified  	O	null

0 מגדלים מגדל מגדלים noun masculine plural absolute unspecified unspecified  	O	null

0 ו ו וחורף conjunction unspecified unspecified unspecified unspecified unspecified 0 
0 חורף חורף וחורף noun masculine singular absolute unspecified unspecified  	I_DATE	null

0 אמיתי אמיתי אמיתי properName masculine singular unspecified unspecified unspecified  	I_PERS	null

0 אני הוא אני pronoun masculine-and-feminine singular unspecified 1 unspecified  	O	null

0 מרגיש הרגיש מרגיש verb masculine singular unspecified any beinoni  	O	null

0 פשוט פשוט פשוט adverb unspecified unspecified unspecified unspecified unspecified  	O	null

0 נפלא נפלא נפלא adjective masculine singular absolute unspecified unspecified  	O	null

0 אבל אבל אבל conjunction unspecified unspecified unspecified unspecified unspecified  	O	null

0 זה זה זה pronoun masculine singular unspecified 3 unspecified  	O	null

0 לא לא לא negation unspecified unspecified unspecified unspecified unspecified  	O	null

0 ביתי ביתי ביתי adjective masculine singular absolute unspecified unspecified  	O	null

0 מייקל מייקל מייקל properName unspecified unspecified unspecified unspecified unspecified  	I_PERS	null

0 בא בא בא verb masculine singular unspecified 3 past  	O	null

0 ו ו ושם conjunction unspecified unspecified unspecified unspecified unspecified 0 
0 שם שם ושם adverb unspecified unspecified unspecified unspecified unspecified  	O	null

0 תקליט תקליט תקליט noun masculine singular absolute unspecified unspecified  	O	null

0 ברק ברק ברק properName unspecified unspecified unspecified unspecified unspecified  	I_PERS	null

0 נדלק נדלק נדלק verb masculine singular unspecified 3 past  	O	null

0 ב ב בחוץ preposition unspecified unspecified unspecified unspecified unspecified 0 
0 ה ה בחוץ definiteArticle unspecified unspecified unspecified unspecified unspecified 0 
0 החוץ חוץ בחוץ noun masculine singular absolute unspecified unspecified  	O	null

0 ו ו ושלום conjunction unspecified unspecified unspecified unspecified unspecified 0 
0 שלום שלום ושלום noun masculine singular absolute unspecified unspecified  	O	null

0 מ מ מדבר preposition unspecified unspecified unspecified unspecified unspecified 0 
0 דבר דבר מדבר noun masculine singular absolute unspecified unspecified  	O	null

0 אנגלית אנגלית אנגלית properName feminine singular unspecified unspecified unspecified  	O	null

0 כמו כמו כמו preposition unspecified unspecified unspecified unspecified unspecified  	O	null

0 ש ש שבקיבוץ relativizer/subordinatingConjunction unspecified unspecified unspecified unspecified unspecified 0 
0 ב ב שבקיבוץ preposition unspecified unspecified unspecified unspecified unspecified 0 
0 ה ה שבקיבוץ definiteArticle unspecified unspecified unspecified unspecified unspecified 0 
0 הקיבוץ קיבוץ שבקיבוץ noun masculine singular absolute unspecified unspecified  	O	null

0 ו ו והוא conjunction unspecified unspecified unspecified unspecified unspecified 0 
0 הוא הוא והוא pronoun masculine singular unspecified 3 unspecified  	O	null

0 הראה הראה הראה verb masculine singular unspecified 3 past  	O	null

0 ל ל לי preposition unspecified unspecified unspecified unspecified unspecified  
0 י י לי pronomial masculine-and-feminine singular unspecified 1 unspecified 0 	O	null

0 את את את at-preposition unspecified unspecified unspecified unspecified unspecified  	O	null

0 ה ה העיר definiteArticle unspecified unspecified unspecified unspecified unspecified 0 
0 העיר עיר העיר noun feminine singular absolute unspecified unspecified  	O	null

0 ו ו ומאיה conjunction unspecified unspecified unspecified unspecified unspecified 0 
0 מאיה מאיה ומאיה properName feminine singular unspecified unspecified unspecified  	I_PERS	null

0 ש ש שגדלה relativizer/subordinatingConjunction unspecified unspecified unspecified unspecified unspecified 0 
0 גדלה גדל שגדלה verb feminine singular unspecified 3 past  	O	null

0 ה ה האנשים definiteArticle unspecified unspecified unspecified unspecified unspecified 0 
0 האנשים איש האנשים noun masculine plural absolute unspecified unspecified  	O	null

0 בריאים בריא בריאים adjective masculine plural absolute unspecified unspecified  	O	null

0 אבל אבל אבל conjunction unspecified unspecified unspecified unspecified unspecified  	O	null

0 ה ה השמש definiteArticle unspecified unspecified unspecified unspecified unspecified 0 
0 השמש שמש השמש noun feminine singular absolute unspecified unspecified  	O	null

0 כאן כאן כאן adverb unspecified unspecified unspecified unspecified unspecified  	O	null

0 חולה חולה חולה adjective masculine singular absolute unspecified unspecified  	O	null

0 הלכנו הלך הלכנו verb masculine-and-feminine plural unspecified 1 past  	O	null

0 ל ל למקום preposition unspecified unspecified unspecified unspecified unspecified 0 
0 מקום מקום למקום noun masculine singular absolute unspecified unspecified  	O	null

0 גדול גדול גדול adjective masculine singular absolute unspecified unspecified  	O	null

0 לשתות שתה לשתות verb unspecified unspecified unspecified unspecified infinitive  	O	null

0 את את אתם at-preposition unspecified unspecified unspecified unspecified unspecified  
0 הם הם אתם pronomial masculine plural unspecified 3 unspecified 0 	O	null

0 יודעים ידע יודעים verb masculine plural unspecified any beinoni  	O	null

0 ו ו ומנגנים conjunction unspecified unspecified unspecified unspecified unspecified 0 
0 מנגנים ניגן ומנגנים verb masculine plural unspecified any beinoni  	O	null

0 שם שם שם adverb unspecified unspecified unspecified unspecified unspecified  	O	null

0 רוקנרול רוקנרול רוקנרול properName unspecified unspecified unspecified unspecified unspecified  	O	null

0 ב ב בכל preposition unspecified unspecified unspecified unspecified unspecified 0 
0 כל כול בכל quantifier unspecified unspecified construct unspecified unspecified  	O	null

0 מיני מין מיני noun masculine plural construct unspecified unspecified  	O	null

0 צבעים צבע צבעים noun masculine plural absolute unspecified unspecified  	O	null

0 ה ה החורף definiteArticle unspecified unspecified unspecified unspecified unspecified 0 
0 החורף חורף החורף noun masculine singular absolute unspecified unspecified  	I_DATE	null

0 בא בא בא verb masculine singular unspecified 3 past  	O	null

0 לכאן לכאן לכאן adverb unspecified unspecified unspecified unspecified unspecified  	O	null

0 מוקדם מוקדם מוקדם adverb unspecified unspecified unspecified unspecified unspecified  	O	null

0 ה ה האור definiteArticle unspecified unspecified unspecified unspecified unspecified 0 
0 האור אור האור noun masculine singular absolute unspecified unspecified  	O	null

0 כבר כבר כבר adverb unspecified unspecified unspecified unspecified unspecified  	O	null

0 לא לא לא negation unspecified unspecified unspecified unspecified unspecified  	O	null

0 עליז עליז עליז adjective masculine singular absolute unspecified unspecified  	O	null

0 אולי אולי אולי adverb unspecified unspecified unspecified unspecified unspecified  	O	null

0 ניסע נסע ניסע verb masculine-and-feminine plural unspecified 1 future  	O	null

0 ל ל לאמסטרדם preposition unspecified unspecified unspecified unspecified unspecified 0 
0 אמסטרדם אמסטרדם לאמסטרדם properName feminine singular unspecified unspecified unspecified  	I_LOC	null

0 ל ל לרומא preposition unspecified unspecified unspecified unspecified unspecified 0 
0 רומא רומא לרומא properName masculine singular unspecified unspecified unspecified  	I_LOC	null

0 או או או conjunction unspecified unspecified unspecified unspecified unspecified  	O	null

0 פאריס פריז פאריס properName unspecified unspecified unspecified unspecified unspecified  	I_LOC	null

