0 כאן כאן כאן adverb unspecified unspecified unspecified unspecified unspecified  	O	null

0 ביתי ביתי ביתי adjective masculine singular absolute unspecified unspecified  	O	null

0 אל אל אל preposition unspecified unspecified unspecified unspecified unspecified  	O	null

0 מול מול מול preposition unspecified unspecified unspecified unspecified unspecified  	O	null

0 גולן גולן גולן properName unspecified unspecified unspecified unspecified unspecified  	I_PERS	null

0 עטור עטור עטור adjective masculine singular absolute unspecified unspecified  	O	null

0 מטע מטע מטע noun masculine singular construct unspecified unspecified  	O	null

0 ו ו וכרם conjunction unspecified unspecified unspecified unspecified unspecified 0 
0 כרם כרם וכרם noun masculine singular absolute unspecified unspecified  	O	null

0 כי כי כי conjunction unspecified unspecified unspecified unspecified unspecified  	O	null

0 אני הוא אני pronoun masculine-and-feminine singular unspecified 1 unspecified  	O	null

0 נולדתי נולד נולדתי verb masculine-and-feminine singular unspecified 1 past  	O	null

0 כאן כאן כאן adverb unspecified unspecified unspecified unspecified unspecified  	O	null

0 עם עם עם preposition unspecified unspecified unspecified unspecified unspecified  	O	null

0 עץ עץ עץ noun masculine singular absolute unspecified unspecified  	O	null

0 הצאלון הצאלון הצאלון properName unspecified unspecified unspecified unspecified unspecified  	I_PERS	null

0 על על על preposition unspecified unspecified unspecified unspecified unspecified  	O	null

0 דשא דשא דשא noun masculine singular absolute unspecified unspecified  	O	null

0 ה ה הגנון definiteArticle unspecified unspecified unspecified unspecified unspecified 0 
0 הגנון גינון הגנון noun masculine singular absolute unspecified unspecified  	O	null

0 השקנו השיק השקנו verb masculine-and-feminine plural unspecified 1 past  	O	null

0 יחד יחד יחד adverb unspecified unspecified unspecified unspecified unspecified  	O	null

0 ה ה הירמוך definiteArticle unspecified unspecified unspecified unspecified unspecified 0 
0 הירמוך הירמוך הירמוך noun masculine singular absolute unspecified unspecified  	O	null

0 עכור עכור עכור adjective masculine singular absolute unspecified unspecified  	O	null

0 ה ה הזרם definiteArticle unspecified unspecified unspecified unspecified unspecified 0 
0 הזרם זרם הזרם noun masculine singular absolute unspecified unspecified  	O	null

0 כפרי כפר כפרי noun masculine plural construct unspecified unspecified  	O	null

0 הדומים הדום הדומים noun masculine plural absolute unspecified unspecified  	O	null

0 ש ש שניערתי relativizer/subordinatingConjunction unspecified unspecified unspecified unspecified unspecified 0 
0 ניערתי ניער שניערתי verb masculine-and-feminine singular unspecified 1 past  	O	null

0 מ מ משיזף preposition unspecified unspecified unspecified unspecified unspecified 0 
0 שיזף שיזף משיזף properName masculine singular unspecified unspecified unspecified  	I_PERS	null

0 כ כ כממטרות preposition unspecified unspecified unspecified unspecified unspecified 0 
0 ממטרות ממטרה כממטרות noun feminine plural construct unspecified unspecified  	O	null

0 תחתן חיתן תחתן verb feminine singular unspecified 3 future  	O	null

0 סובבתי סובב סובבתי verb masculine-and-feminine singular unspecified 1 past  	O	null

0 ב ב בשרב preposition unspecified unspecified unspecified unspecified unspecified 0 
0 ה ה בשרב definiteArticle unspecified unspecified unspecified unspecified unspecified 0 
0 השרב שרב בשרב noun masculine singular absolute unspecified unspecified  	O	null

0 כ כ כציפורים preposition unspecified unspecified unspecified unspecified unspecified 0 
0 ציפורים ציפור כציפורים noun masculine plural absolute unspecified unspecified  	O	null

0 ש ש שהעירוני relativizer/subordinatingConjunction unspecified unspecified unspecified unspecified unspecified 0 
0 ה ה שהעירוני definiteArticle unspecified unspecified unspecified unspecified unspecified 0 
0 העירוני עירוני שהעירוני adjective masculine singular absolute unspecified unspecified  	I_ORG	null

0 ב ב בקולן preposition unspecified unspecified unspecified unspecified unspecified 0 
0 קולן קולן בקולן noun masculine singular absolute unspecified unspecified  	O	null

0 - - - punctuation unspecified unspecified unspecified unspecified unspecified  	O	null

0 כאן כאן כאן adverb unspecified unspecified unspecified unspecified unspecified  	O	null

0 ביתי ביתי ביתי adjective masculine singular absolute unspecified unspecified  	O	null

0 אל אל אל preposition unspecified unspecified unspecified unspecified unspecified  	O	null

0 מול מול מול preposition unspecified unspecified unspecified unspecified unspecified  	O	null

0 גולן גולן גולן properName unspecified unspecified unspecified unspecified unspecified  	I_PERS	null

