0 לאחד איחד לאחד verb unspecified unspecified unspecified unspecified infinitive  	O	null

0 הוא הוא הוא pronoun masculine singular unspecified 3 unspecified  	O	null

0 קוטף קטף קוטף verb masculine singular unspecified any beinoni  	O	null

0 פרח פרח פרח noun masculine singular absolute unspecified unspecified  	O	null

0 ל ל לשני preposition unspecified unspecified unspecified unspecified unspecified 0 
0 שני שני לשני noun masculine singular absolute unspecified unspecified  	O	null

0 כוכב כוכב כוכב noun masculine singular construct unspecified unspecified  	O	null

0 ו ו וכל conjunction unspecified unspecified unspecified unspecified unspecified 0 
0 כל כול וכל quantifier unspecified unspecified construct unspecified unspecified  	O	null

0 מי מי מי interrogative unspecified unspecified unspecified unspecified unspecified  	O	null

0 ש ש שקיבל relativizer/subordinatingConjunction unspecified unspecified unspecified unspecified unspecified 0 
0 קיבל קיבל שקיבל verb masculine singular unspecified 3 past  	O	null

0 לוחש לחש לוחש verb masculine singular unspecified any beinoni  	O	null

0 ל ל לעצמו preposition unspecified unspecified unspecified unspecified unspecified 0 
0 עצמו עצמו לעצמו pronoun unspecified unspecified unspecified unspecified unspecified  
0 ו ו לעצמו pronomial masculine singular unspecified 3 unspecified 0 	O	null

0 " " " punctuation unspecified unspecified unspecified unspecified unspecified  	O	null
1 עוד עוד עוד noun masculine singular construct unspecified unspecified  	O	null

0 לואיס לואיס לואיס properName unspecified unspecified unspecified unspecified unspecified  	I_PERS	null

0 לואיס לואיס לואיס properName unspecified unspecified unspecified unspecified unspecified  	I_PERS	null

0 איזה איזה איזה quantifier unspecified unspecified construct unspecified unspecified  	O	null

0 לב לב לב noun masculine singular absolute unspecified unspecified  	O	null

0 רחב רחב רחב adjective masculine singular absolute unspecified unspecified  	O	null
1 " " " punctuation unspecified unspecified unspecified unspecified unspecified  	O	null

