0 קשה קשה קשה adverb unspecified unspecified unspecified unspecified unspecified  	O	null

0 ל ל להיות preposition unspecified unspecified unspecified unspecified unspecified 0 
0 היות היות להיות noun masculine singular construct unspecified unspecified  	O	null

0 משה משה משה properName unspecified unspecified unspecified unspecified unspecified  	I_PERS	null

0 ו ו ובתיבה conjunction unspecified unspecified unspecified unspecified unspecified 0 
0 ב ב ובתיבה preposition unspecified unspecified unspecified unspecified unspecified 0 
0 תיבה תיבה ובתיבה noun feminine singular absolute unspecified unspecified  	O	null

0 נורא נורא נורא adjective masculine singular absolute unspecified unspecified  	O	null

0 צפוף צפוף צפוף adjective masculine singular absolute unspecified unspecified  	O	null

0 לא לא לא negation unspecified unspecified unspecified unspecified unspecified  	O	null

0 נוח נוח נוח noun masculine singular absolute unspecified unspecified  	O	null

0 ל ל לי preposition unspecified unspecified unspecified unspecified unspecified  
0 י י לי pronomial masculine-and-feminine singular unspecified 1 unspecified 0 	O	null

0 כי כי כי conjunction unspecified unspecified unspecified unspecified unspecified  	O	null

0 נח נח נח verb masculine singular unspecified 3 past  	O	null

0 מת מת מת verb masculine singular unspecified 3 past  	O	null

0 אבל אבל אבל conjunction unspecified unspecified unspecified unspecified unspecified  	O	null

0 הוא הוא הוא pronoun masculine singular unspecified 3 unspecified  	O	null

0 עוד עוד עוד adverb unspecified unspecified unspecified unspecified unspecified  	O	null

0 ישוב יישוב ישוב noun masculine singular absolute unspecified unspecified  	O	null

0 ו ו ואין conjunction unspecified unspecified unspecified unspecified unspecified 0 
0 אין אין ואין negation unspecified unspecified unspecified unspecified unspecified  	O	null

0 צדיק צדיק צדיק noun masculine singular absolute unspecified unspecified  	O	null

0 אחד איחד אחד verb masculine singular unspecified 3 past  	O	null

0 ב ב בסדום preposition unspecified unspecified unspecified unspecified unspecified 0 
0 סדום סדום בסדום properName masculine singular unspecified unspecified unspecified  	I_LOC	null

0 העירה העיר העירה verb feminine singular unspecified 3 past  	O	null

0 ה ה המורה definiteArticle unspecified unspecified unspecified unspecified unspecified 0 
0 המורה מורה המורה noun masculine singular absolute unspecified unspecified  	O	null

0 כש כש כששמעה temporalSubConj unspecified unspecified unspecified unspecified unspecified 0 
0 שמעה שמע כששמעה verb feminine singular unspecified 3 past  	O	null

0 עד עד עד noun masculine singular absolute unspecified unspecified  	O	null

0 כמה כמה כמה quantifier unspecified unspecified construct unspecified unspecified  	O	null

0 אברהם אברהם אברהם properName unspecified unspecified unspecified unspecified unspecified  	I_PERS	null

0 שנא שנא שנא verb masculine singular unspecified 3 past  	O	null

0 את את את at-preposition unspecified unspecified unspecified unspecified unspecified  	O	null

0 מתנה מתנה מתנה noun feminine singular absolute unspecified unspecified  	O	null

0 ו ו ואמא conjunction unspecified unspecified unspecified unspecified unspecified 0 
0 אמא אמא ואמא noun feminine singular absolute unspecified unspecified  	O	null

0 שר שר שרה noun masculine singular absolute unspecified unspecified  
0 ה ה שרה possessive feminine singular unspecified 3 unspecified 0 	O	null

0 נדהמה נדהם נדהמה verb feminine singular unspecified 3 past  	O	null

0 ו ו ונחנקה conjunction unspecified unspecified unspecified unspecified unspecified 0 
0 נחנקה נחנק ונחנקה verb feminine singular unspecified 3 past  	O	null

0 מ מ מצחוק preposition unspecified unspecified unspecified unspecified unspecified 0 
0 צחוק צחוק מצחוק noun masculine singular absolute unspecified unspecified  	O	null

0 שלמה שלמה שלמה properName unspecified unspecified unspecified unspecified unspecified  	I_PERS	null

0 חכם חכם חכם adjective masculine singular absolute unspecified unspecified  	O	null

0 הניף הניף הניף verb masculine singular unspecified 3 past  	O	null

0 את את את at-preposition unspecified unspecified unspecified unspecified unspecified  	O	null

0 ה ה החרב definiteArticle unspecified unspecified unspecified unspecified unspecified 0 
0 החרב חרב החרב noun feminine singular absolute unspecified unspecified  	O	null

0 כדי כדי כדי conjunction unspecified unspecified unspecified unspecified unspecified  	O	null

0 ל ל לחצות preposition unspecified unspecified unspecified unspecified unspecified 0 
0 חצות חצות לחצות noun feminine singular absolute unspecified unspecified  	I_TIME	null

0 את את את at-preposition unspecified unspecified unspecified unspecified unspecified  	O	null

0 ה ה התינוק definiteArticle unspecified unspecified unspecified unspecified unspecified 0 
0 התינוק תינוק התינוק noun masculine singular absolute unspecified unspecified  	O	null

0 יוסף יוסף יוסף properName unspecified unspecified unspecified unspecified unspecified  	I_PERS	null

0 היה הוא היה copula masculine singular unspecified 3 past  	O	null

0 אוסף אוסף אוסף noun masculine singular absolute unspecified unspecified  	O	null

0 סיבות סיבה סיבות noun feminine plural absolute unspecified unspecified  	O	null

0 להיזרק נזרק להיזרק verb unspecified unspecified unspecified unspecified infinitive  	O	null

0 ל ל לבור preposition unspecified unspecified unspecified unspecified unspecified 0 
0 בור בור לבור noun masculine singular absolute unspecified unspecified  	O	null

0 לא לא לא negation unspecified unspecified unspecified unspecified unspecified  	O	null

0 נוח נוח נוח noun masculine singular absolute unspecified unspecified  	O	null

0 שם שם שם adverb unspecified unspecified unspecified unspecified unspecified  	O	null

0 כי כי כי conjunction unspecified unspecified unspecified unspecified unspecified  	O	null

0 נח נח נח verb masculine singular unspecified 3 past  	O	null

0 מת מת מת verb masculine singular unspecified 3 past  	O	null

0 ו ו והוא conjunction unspecified unspecified unspecified unspecified unspecified 0 
0 הוא הוא והוא pronoun masculine singular unspecified 3 unspecified  	O	null

0 כבר כבר כבר adverb unspecified unspecified unspecified unspecified unspecified  	O	null

0 לא לא לא negation unspecified unspecified unspecified unspecified unspecified  	O	null

0 יחזור חזר יחזור verb masculine singular unspecified 3 future  	O	null

0 רחב רחב רחב adjective masculine singular absolute unspecified unspecified  	O	null

0 היתה הוא היתה copula feminine singular unspecified 3 past  	O	null

0 זונה זונה זונה noun feminine singular absolute unspecified unspecified  	O	null

0 בגלל בגלל בגלל preposition unspecified unspecified unspecified unspecified unspecified  	O	null

0 ש ש שלא relativizer/subordinatingConjunction unspecified unspecified unspecified unspecified unspecified 0 
0 לא לא שלא negation unspecified unspecified unspecified unspecified unspecified  	O	null

0 מצאה מצא מצאה verb feminine singular unspecified 3 past  	O	null

0 חתן חתן חתן noun masculine singular construct unspecified unspecified  	O	null

0 אהב אהב אהב verb masculine singular unspecified 3 past  	O	null

0 דוד דוד דוד properName unspecified unspecified unspecified unspecified unspecified  	I_PERS	null

0 את את את at-preposition unspecified unspecified unspecified unspecified unspecified  	O	null

0 יוני יוני יוני properName unspecified unspecified unspecified unspecified unspecified  	I_PERS	null

0 את את את at-preposition unspecified unspecified unspecified unspecified unspecified  	O	null

0 יונה יונה יונה properName unspecified unspecified unspecified unspecified unspecified  	I_PERS	null

0 הלוית הלוויה הלויתן noun feminine singular absolute unspecified unspecified  
0 ן ן הלויתן possessive feminine plural unspecified 3 unspecified 0 	O	null

0 ו ו ורק conjunction unspecified unspecified unspecified unspecified unspecified 0 
0 רק רק ורק conjunction unspecified unspecified unspecified unspecified unspecified  	O	null

0 בת בת בת noun feminine singular construct unspecified unspecified  	O	null

0 שבע שבע שבע adjective masculine singular absolute unspecified unspecified  	O	null

0 נדחקה נדחק נדחקה verb feminine singular unspecified 3 past  	O	null

0 כי כי כי conjunction unspecified unspecified unspecified unspecified unspecified  	O	null

0 מישהו מישהו מישהו noun masculine singular absolute unspecified unspecified  	O	null

0 ב ב בקהל preposition unspecified unspecified unspecified unspecified unspecified 0 
0 ה ה בקהל definiteArticle unspecified unspecified unspecified unspecified unspecified 0 
0 הקהל קהל בקהל noun masculine singular absolute unspecified unspecified  	O	null

0 הוא הוא הוא pronoun masculine singular unspecified 3 unspecified  	O	null

0 לא לא לא negation unspecified unspecified unspecified unspecified unspecified  	O	null

0 אהב אהב אהב verb masculine singular unspecified 3 past  	O	null

0 את את אותה at-preposition unspecified unspecified unspecified unspecified unspecified  
0 ה ה אותה pronomial feminine singular unspecified 3 unspecified 0 	O	null

0 ו ו ואת conjunction unspecified unspecified unspecified unspecified unspecified 0 
0 את את ואת at-preposition unspecified unspecified unspecified unspecified unspecified  	O	null

0 ה ה האינטרנשיונל definiteArticle unspecified unspecified unspecified unspecified unspecified 0 
0 האינטרנשיונל האינטרנשיונל האינטרנשיונל noun masculine singular absolute unspecified unspecified  	O	null

0 קשה קשה קשה adverb unspecified unspecified unspecified unspecified unspecified  	O	null

0 ל ל להיות preposition unspecified unspecified unspecified unspecified unspecified 0 
0 היות היות להיות noun masculine singular construct unspecified unspecified  	O	null

0 משה משה משה properName unspecified unspecified unspecified unspecified unspecified  	I_PERS	null

0 בסוף בסוף בסוף adverb unspecified unspecified unspecified unspecified unspecified  	O	null

0 אתה הוא אתה pronoun masculine singular unspecified 2 unspecified  	O	null

0 נשאר נשאר נשאר verb masculine singular unspecified 3 past  	O	null

0 ב ב בחוץ preposition unspecified unspecified unspecified unspecified unspecified 0 
0 ה ה בחוץ definiteArticle unspecified unspecified unspecified unspecified unspecified 0 
0 החוץ חוץ בחוץ noun masculine singular absolute unspecified unspecified  	O	null

0 ו ו וכל conjunction unspecified unspecified unspecified unspecified unspecified 0 
0 כל כול וכל quantifier unspecified unspecified construct unspecified unspecified  	O	null

0 ה ה העם definiteArticle unspecified unspecified unspecified unspecified unspecified 0 
0 העם עם העם noun masculine singular absolute unspecified unspecified  	O	null

0 ב ב בישראל preposition unspecified unspecified unspecified unspecified unspecified 0 
0 ישראל ישראל בישראל properName unspecified unspecified unspecified unspecified unspecified  	I_LOC	null

0 נמצא נמצא נמצא verb masculine singular unspecified 3 past  	O	null

0 על על על preposition unspecified unspecified unspecified unspecified unspecified  	O	null

0 סף סף סף noun masculine singular construct unspecified unspecified  	O	null

0 פיצוץ פיצוץ פיצוץ noun masculine singular absolute unspecified unspecified  	O	null

0 משה משה משה properName unspecified unspecified unspecified unspecified unspecified  	I_PERS	null

0 הזה הזה הזה verb masculine singular unspecified 3 past  	O	null

0 אולי אולי אולי adverb unspecified unspecified unspecified unspecified unspecified  	O	null

0 גימגם גמגם גימגם verb masculine singular unspecified 3 past  	O	null

0 אבל אבל אבל conjunction unspecified unspecified unspecified unspecified unspecified  	O	null

0 עשה עשה עשה verb masculine singular unspecified 3 past  	O	null

0 המון המון המון noun masculine singular absolute unspecified unspecified  	O	null

0 את את אתם at-preposition unspecified unspecified unspecified unspecified unspecified  
0 הם הם אתם pronomial masculine plural unspecified 3 unspecified 0 	O	null

0 דיברתם דיבר דיברתם verb masculine plural unspecified 2 past  	O	null

0 ו ו ודיברתם conjunction unspecified unspecified unspecified unspecified unspecified 0 
0 דיברתם דיבר ודיברתם verb masculine plural unspecified 2 past  	O	null

0 ו ו והגיע conjunction unspecified unspecified unspecified unspecified unspecified 0 
0 הגיע הגיע והגיע verb masculine singular unspecified 3 past  	O	null

0 זמן זמן זמן noun masculine singular absolute unspecified unspecified  	O	null

0 ל ל לסתום preposition unspecified unspecified unspecified unspecified unspecified 0 
0 סתום סתום לסתום adjective masculine singular absolute unspecified unspecified  	O	null

0 ו ו ולעשות conjunction unspecified unspecified unspecified unspecified unspecified 0 
0 לעשות עשה ולעשות verb unspecified unspecified unspecified unspecified infinitive  	O	null

