0 אט אט אט adverb unspecified unspecified unspecified unspecified unspecified  	O	null

0 זורמת זרם זורמת verb feminine singular unspecified any beinoni  	O	null

0 ב ב בנפשי preposition unspecified unspecified unspecified unspecified unspecified 0 
0 נפשי נפשי בנפשי adjective masculine singular absolute unspecified unspecified  	O	null

0 מנגינת מנגינה מנגינת noun feminine singular construct unspecified unspecified  	O	null

0 ה ה הטוהר definiteArticle unspecified unspecified unspecified unspecified unspecified 0 
0 הטוהר טוהר הטוהר noun masculine singular absolute unspecified unspecified  	O	null

0 עוף עוף עופה noun masculine singular absolute unspecified unspecified  
0 ה ה עופה possessive feminine singular unspecified 3 unspecified 0 	O	null

0 שיר שיר שיר noun masculine singular absolute unspecified unspecified  	O	null

0 אביב אביב אביב properName unspecified unspecified unspecified unspecified unspecified  	I_PERS	null

0 חפשי חיפש חפשי verb feminine singular unspecified 2 imperative  	O	null

0 אל אל אל preposition unspecified unspecified unspecified unspecified unspecified  	O	null

0 מרחב מרחב מרחב noun masculine singular construct unspecified unspecified  	O	null

0 שטוף שטף שטוף verb masculine singular unspecified 2 imperative  	O	null

0 זוהר זוהר זוהר properName unspecified unspecified unspecified unspecified unspecified  	I_PERS	null

0 עוף עוף עופה noun masculine singular absolute unspecified unspecified  
0 ה ה עופה possessive feminine singular unspecified 3 unspecified 0 	O	null

0 נא נא נא interjection unspecified unspecified unspecified unspecified unspecified  	O	null

0 אל אל אל preposition unspecified unspecified unspecified unspecified unspecified  	O	null

0 ה ה הגינה definiteArticle unspecified unspecified unspecified unspecified unspecified 0 
0 הגינה גינה הגינה noun feminine singular absolute unspecified unspecified  	O	null

0 ב ב בה preposition unspecified unspecified unspecified unspecified unspecified  
0 ה ה בה pronomial feminine singular unspecified 3 unspecified 0 	O	null

0 פריחה פריחה פריחה noun feminine singular absolute unspecified unspecified  	O	null

0 ה ה התחילה definiteArticle unspecified unspecified unspecified unspecified unspecified 0 
0 התחילה תחילה התחילה noun feminine singular absolute unspecified unspecified  	O	null

0 אם אם אם conjunction unspecified unspecified unspecified unspecified unspecified  	O	null

0 תפגוש פגש תפגוש verb feminine singular unspecified 3 future  	O	null

0 ב ב בשושנה preposition unspecified unspecified unspecified unspecified unspecified 0 
0 שושנה שושנה בשושנה properName feminine singular unspecified unspecified unspecified  	I_PERS	null

0 תן תן תן noun masculine singular absolute unspecified unspecified  	O	null

0 את את את at-preposition unspecified unspecified unspecified unspecified unspecified  	O	null

0 ברכתי בירך ברכתי verb masculine-and-feminine singular unspecified 1 past  	O	null

0 ל ל לה preposition unspecified unspecified unspecified unspecified unspecified  
0 ה ה לה pronomial feminine singular unspecified 3 unspecified 0 	O	null

